"rank","movie","year_released","american_box_office","international_box_office","total_box_office"
1,"Avatar",2009,760507625,2015837654,2776345279
2,"Titanic",1997,659363944,1548844451,2208208395
3,"Star Wars Ep. VII: The Force Awakens",2015,936662225,1116648995,2053311220
4,"Avengers: Infinity War",2018,678815482,1369982200,2048797682
5,"Jurassic World",2015,652270625,996584239,1648854864
6,"Furious 7",2015,353007020,1165715774,1518722794
7,"The Avengers",2012,623279547,894656350,1517935897
8,"Avengers: Age of Ultron",2015,459005868,944008095,1403013963
9,"Black Panther",2018,700059566,648198658,1348258224
10,"Harry Potter and the Deathly Hallows: Part II",2011,381193157,960500000,1341693157
11,"Star Wars Ep. VIII: The Last Jedi",2017,620181382,696540365,1316721747
12,"Jurassic World: Fallen Kingdom",2018,417719760,888053039,1305772799
13,"Frozen",2013,400738009,871731901,1272469910
14,"Beauty and the Beast",2017,504014165,755185541,1259199706
15,"Incredibles 2",2018,608581744,633950692,1242532436
16,"The Fate of the Furious",2017,225764765,1009081502,1234846267
17,"Iron Man 3",2013,408992272,806400000,1215392272
18,"Minions",2015,336045770,824290403,1160336173
19,"Aquaman",2018,335061807,811832833,1146894640
20,"The Lord of the Rings: The Return of the King",2003,377845905,763557436,1141403341
21,"Captain America: Civil War",2016,408084349,731985064,1140069413
22,"Transformers: Dark of the Moon",2011,352390543,771400000,1123790543
23,"Skyfall",2012,304360277,806166704,1110526981
24,"Transformers: Age of Extinction",2014,245439076,858600000,1104039076
25,"Captain Marvel",2019,400026133,689500000,1089526133
26,"The Dark Knight Rises",2012,448139099,636300000,1084439099
27,"Toy Story 3",2010,415004880,653874642,1068879522
28,"Pirates of the Caribbean: Dead Man’s Chest",2006,423315812,642900000,1066215812
29,"Rogue One: A Star Wars Story",2016,532177324,516925532,1049102856
30,"Pirates of the Caribbean: On Stranger Tides",2011,241063875,804600000,1045663875
31,"Jurassic Park",1993,395708305,643104279,1038812584
32,"Despicable Me 3",2017,264624300,770198073,1034822373
33,"Star Wars Ep. I: The Phantom Menace",1999,474544677,552500000,1027044677
34,"Alice in Wonderland",2010,334191110,691300000,1025491110
35,"Finding Dory",2016,486295561,534919632,1021215193
36,"Zootopia",2016,341268248,678436100,1019704348
37,"The Hobbit: An Unexpected Journey",2012,303003568,714000000,1017003568
38,"The Dark Knight",2008,533720947,468275260,1001996207
39,"The Lion King",1994,421785283,564429585,986214868
40,"Despicable Me 2",2013,368065385,607151450,975216835
41,"Harry Potter and the Sorcerer’s Stone",2001,317871467,657176139,975047606
42,"Jumanji: Welcome to the Jungle",2017,404508916,559987277,964496193
43,"Pirates of the Caribbean: At World’s End",2007,309420425,654000000,963420425
44,"The Jungle Book",2016,364001123,598853424,962854547
45,"Harry Potter and the Deathly Hallows: Part I",2010,296131568,664300000,960431568
46,"The Hobbit: The Desolation of Smaug",2013,258366855,702000000,960366855
47,"The Hobbit: The Battle of the Five Armies",2014,255119788,690457833,945577621
48,"Harry Potter and the Order of the Phoenix",2007,292137260,650939197,943076457
49,"Shrek 2",2004,441226247,495781885,937008132
50,"Finding Nemo",2003,380529370,555900000,936429370
51,"Harry Potter and the Half-Blood Prince",2009,302089278,633124489,935213767
52,"The Lord of the Rings: The Two Towers",2002,342548984,592150661,934699645
53,"Bohemian Rhapsody",2018,216266865,685600000,901866865
54,"Harry Potter and the Goblet of Fire",2005,290201752,606898042,897099794
55,"Spider-Man 3",2007,336530303,558329927,894860230
56,"The Lord of the Rings: The Fellowship of the Ring",2001,315544750,571666235,887210985
57,"The Secret Life of Pets",2016,368384330,518383092,886767422
58,"Spider-Man: Homecoming",2017,334201140,545965210,880166350
59,"Ice Age: Continental Drift",2012,161321843,718443294,879765137
60,"Spectre",2015,200074175,679546748,879620923
61,"Harry Potter and the Chamber of Secrets",2002,262233381,616991754,879225135
62,"Batman v Superman: Dawn of Justice",2016,330360194,537140087,867500281
63,"The Hunger Games: Catching Fire",2013,424668047,440200000,864868047
64,"Guardians of the Galaxy Vol 2",2017,389813101,472503132,862316233
65,"Ice Age: Dawn of the Dinosaurs",2009,196573705,663128152,859701857
66,"Zhan Lang 2",2017,2721100,855881967,858603067
67,"Inside Out",2015,356461711,497774281,854235992
68,"Venom",2018,213511408,640117197,853628605
69,"Star Wars Ep. III: Revenge of the Sith",2005,380270577,468728300,848998877
70,"Thor: Ragnarok",2017,315058289,531921735,846980024
71,"Transformers: Revenge of the Fallen",2009,402111870,434407829,836519699
72,"Inception",2010,292576195,539825887,832402082
73,"The Twilight Saga: Breaking Dawn, Part 2",2012,292324737,537400000,829724737
74,"Spider-Man",2002,403706375,418000000,821706375
75,"Wonder Woman",2017,412563408,408569970,821133378
76,"Independence Day",1996,306169255,511231623,817400878
77,"Shrek the Third",2007,322719944,484610992,807330936
78,"Fantastic Beasts and Where to Find Them",2016,234037575,568365278,802402853
79,"Deadpool",2016,363070709,437954884,801025593
80,"Coco",2017,209726015,588294210,798020225
81,"Harry Potter and the Prisoner of Azkaban",2004,249757726,547149597,796907323
82,"Spider-Man 2",2004,373524485,421586185,795110670
83,"ET: The Extra-Terrestrial",1982,435110554,357854772,792965326
84,"Fast and Furious 6",2013,238679850,550620594,789300444
85,"Pirates of the Caribbean: Dead Men Tell No Tales",2017,172558876,615682261,788241137
86,"Mission: Impossible—Fallout",2018,220159104,567297448,787456552
87,"Deadpool 2",2018,324591735,462088822,786680557
88,"Indiana Jones and the Kingdom of the Crystal Skull",2008,317101119,469534294,786635413
89,"Star Wars Ep. IV: A New Hope",1977,460998007,325600000,786598007
90,"Guardians of the Galaxy",2014,333172112,437695404,770867516
91,"The Da Vinci Code",2006,217536138,550284321,767820459
92,"The Hunger Games: Mockingjay - Part 1",2014,337135885,429439246,766575131
93,"Maleficent",2014,241407328,517129407,758536735
94,"The Amazing Spider-Man",2012,262030663,495859604,757890267
95,"2012",2009,166112167,591565581,757677748
96,"Shrek Forever After",2010,238736787,517507886,756244673
97,"X-Men: Days of Future Past",2014,233921534,513941241,747862775
98,"Madagascar 3: Europe's Most Wanted",2012,216391482,530529789,746921271
99,"Suicide Squad",2016,325100054,420959833,746059887
100,"Monsters University",2013,268488329,475100000,743588329
101,"The Matrix Reloaded",2003,281553689,457023240,738576929
102,"Up",2009,293004164,438459213,731463377
103,"The Chronicles of Narnia: The Lion, the Witch a…",2005,291710957,428828615,720539572
104,"Captain America: The Winter Soldier",2014,259746958,454654931,714401889
105,"Dawn of the Planet of the Apes",2014,208545589,502098977,710644566
106,"The Amazing Spider-Man 2",2014,202853933,506142403,708996336
107,"Transformers",2007,319246193,389026399,708272592
108,"The Twilight Saga: Eclipse",2010,300531751,405571077,706102828
109,"It",2017,327481748,369976221,697457969
110,"Liu Lang Di Qiu",2019,0,695077536,695077536
111,"Mission: Impossible—Ghost Protocol",2011,209397903,485315327,694713230
112,"Gravity",2013,274092705,419605968,693698673
113,"The Twilight Saga: Breaking Dawn, Part 1",2011,281287133,408132918,689420051
114,"Mission: Impossible—Rogue Nation",2015,195042377,493816615,688858992
115,"The Twilight Saga: New Moon",2009,296623634,390934093,687557727
116,"Forrest Gump",1994,330151138,349699499,679850637
117,"The Hunger Games",2012,408010692,269912687,677923379
118,"Doctor Strange",2016,232641920,443762646,676404566
119,"The Sixth Sense",1999,293506292,379300000,672806292
120,"Man of Steel",2013,291045518,376954000,667999518
121,"Interstellar",2014,188017894,478361481,666379375
122,"Kung Fu Panda 2",2011,165249063,499588484,664837547
123,"Star Wars Ep. II: Attack of the Clones",2002,310676740,346018875,656695615
124,"Justice League",2017,229024295,426920914,655945209
125,"The Martian",2015,228433663,426837780,655271443
126,"Men in Black 3",2012,179020854,475192631,654213485
127,"Fantastic Beasts: The Crimes of Grindelwald",2018,159555901,492664185,652220086
128,"Big Hero 6",2014,222527828,429600000,652127828
129,"Ice Age: The Meltdown",2006,195330621,456568661,651899282
130,"The Hunger Games: Mockingjay - Part 2",2015,281723902,367262885,648986787
131,"Thor: The Dark World",2013,206362140,438240376,644602516
132,"Moana",2016,248757044,388760321,637517365
133,"Pirates of the Caribbean: The Curse of the Blac…",2003,305411224,329542879,634954103
134,"Sing",2016,270329045,364125744,634454789
135,"Kung Fu Panda",2008,215434591,416475940,631910531
136,"Fast Five",2011,210031325,420132129,630163454
137,"Ratatouille",2007,206445654,420104041,626549695
138,"Hancock",2008,227946274,396287998,624234272
139,"Ant-Man and the Wasp",2018,216648740,406495920,623144660
140,"The Passion of the Christ",2004,370782930,251558994,622341924
141,"Iron Man 2",2010,312433331,308723058,621156389
142,"The Lost World: Jurassic Park",1997,229086679,389552320,618638999
143,"Mamma Mia!",2008,144130063,471618709,615748772
144,"Logan",2017,226277068,389184326,615461394
145,"The Incredibles",2004,261441092,353285660,614726752
146,"How to Train Your Dragon 2",2014,177002924,437583346,614586270
147,"Beauty and the Beast",1991,376057266,232373866,608431132
148,"Life of Pi",2012,124987022,482271612,607258634
149,"War of the Worlds",2005,234280354,372556181,606836535
150,"Transformers: The Last Knight",2017,130168683,472724657,602893340
151,"Madagascar: Escape 2 Africa",2008,180174880,419505894,599680774
152,"Casino Royale",2006,167365000,427055283,594420283
153,"Quantum of Solace",2008,169368427,422323651,591692078
154,"Men in Black",1997,250690539,337100000,587790539
155,"Tangled",2010,200821936,385655304,586477240
156,"The Hangover Part II",2011,254464305,332000000,586464305
157,"I am Legend",2007,256393010,329139674,585532684
158,"Iron Man",2008,318604126,266567421,585171547
159,"Night at the Museum",2006,250863268,328583139,579446407
160,"Ready Player One",2018,137690172,441599964,579290136
161,"Hong Hai Xing Dong",2018,1543547,576647204,578190751
162,"The Croods",2013,187168425,385900000,573068425
163,"Star Wars Ep. VI: Return of the Jedi",1983,309205079,263500000,572705079
164,"Fifty Shades of Grey",2015,166167230,404830871,570998101
165,"The Smurfs",2011,142614158,421135165,563749323
166,"Kong: Skull Island",2017,168052812,393019247,561072059
167,"Cars 2",2011,191450875,368704508,560155383
168,"Monsters, Inc.",2001,289423425,270334294,559757719
169,"Madagascar",2005,193595521,362964045,556559566
170,"The Day After Tomorrow",2004,186740799,369578651,556319450
171,"Ted",2012,218665740,337350887,556016627
172,"Puss in Boots",2011,149260504,405726973,554987477
173,"Brave",2012,237282182,317324350,554606532
174,"Armageddon",1998,201578182,353021818,554600000
175,"Mei Ren Yu",2016,3229457,551287214,554516671
176,"King Kong",2005,218080025,332437332,550517357
177,"Mission: Impossible 2",2000,215409889,334178627,549588516
178,"American Sniper",2014,350126372,197200000,547326372
179,"Tang Ren Jie Tan An 2",2018,1983984,542084590,544068574
180,"Despicable Me",2010,251513985,291950588,543464573
181,"X-Men: Apocalypse",2016,155442489,387095057,542537546
182,"Sherlock Holmes: A Game of Shadows",2011,186848418,348815025,535663443
183,"Cinderella",2015,201151353,333400000,534551353
184,"Star Wars Ep. V: The Empire Strikes Back",1980,290271960,243889374,534161334
185,"The Revenant",2015,183637894,349300408,532938302
186,"WALL-E",2008,223808164,308699861,532508025
187,"World War Z",2013,202359711,329154939,531514650
188,"The Meg",2018,145443742,384086973,529530715
189,"Godzilla",2014,200676069,328400000,529076069
190,"Hotel Transylvania 3: Summer Vacation",2018,167500092,359577586,527077678
191,"The Simpsons Movie",2007,183135014,343936008,527071022
192,"Ralph Breaks The Internet",2018,201091711,323196956,524288667
193,"Ant-Man",2015,180202163,338656286,518858449
194,"Ghost",1990,217631306,299968694,517600000
195,"Kung Fu Panda 3",2016,143528619,374070523,517599142
196,"Meet the Fockers",2004,279167575,237400000,516567575
197,"Terminator 2: Judgment Day",1991,203464105,311955722,515419827
198,"How to Train Your Dragon: The Hidden World",2019,159105140,355400000,514505140
199,"Toy Story 2",1999,245852179,265506097,511358276
200,"Dr. Seuss’ The Grinch",2018,270620950,240387329,511008279
201,"The Boss Baby",2017,175003033,335875729,510878762
202,"Aladdin",1992,217350219,286700000,504050219
203,"Dunkirk",2017,190068280,309769088,499837368
204,"Sherlock Holmes",2009,209028679,289409533,498438212
205,"Wreck-It Ralph",2012,189412677,307098844,496511521
206,"Twister",1996,241688385,254011615,495700000
207,"How to Train Your Dragon",2010,217581232,277289760,494870992
208,"Clash of the Titans",2010,163214888,330000000,493214888
209,"Rio 2",2014,131538435,361307856,492846291
210,"Shrek",2001,267655011,224157783,491812794
211,"Angels & Demons",2009,133375846,357500000,490875846
212,"Oz the Great and Powerful",2013,234770996,255588055,490359051
213,"War for the Planet of the Apes",2017,146880162,342712105,489592267
214,"Rio",2011,143619809,343900000,487519809
215,"Mr. and Mrs. Smith",2005,186336279,299787811,486124090
216,"Saving Private Ryan",1998,216335085,268700000,485035085
217,"Teenage Mutant Ninja Turtles",2014,191204754,293800000,485004754
218,"Les Intouchables",2012,13182281,471690764,484873045
219,"Bruce Almighty",2003,242704995,241763613,484468608
220,"Troy",2004,133298577,350862688,484161265
221,"Home Alone",1990,285761243,190923432,476684675
222,"Charlie and the Chocolate Factory",2005,206459076,269366408,475825484
223,"Indiana Jones and the Last Crusade",1989,197171806,277000000,474171806
224,"Rise of the Planet of the Apes",2011,176760185,294226015,470986200
225,"Jaws",1975,260000000,210700000,470700000
226,"Hotel Transylvania 2",2015,169700110,299800188,469500298
227,"Star Trek Into Darkness",2013,228778661,238602923,467381584
228,"The Hangover",2009,277322503,188441583,465764086
229,"Bumblebee",2018,127195589,338000000,465195589
230,"The Matrix",1999,171479930,292037453,463517383
231,"Cars",2006,244082982,217568264,461651246
232,"X-Men: The Last Stand",2006,234362462,224898484,459260946
233,"The Lego Movie",2014,257784718,199944670,457729388
234,"Mission: Impossible",1996,180981886,276716108,457697994
235,"Gladiator",2000,187683805,270000000,457683805
236,"Lucy",2014,126573960,330933816,457507776
237,"National Treasure: Book of Secrets",2007,219961501,237364303,457325804
238,"The Last Samurai",2003,111110575,345700000,456810575
239,"San Andreas",2015,155190832,301067707,456258539
240,"300",2007,210614939,243546996,454161935
241,"Wo Bi Shi Yao Shen",2018,0,451176640,451176640
242,"Ocean's Eleven",2001,183417150,267311379,450728529
243,"Django Unchained",2012,162805434,287142889,449948323
244,"Thor",2011,181030624,268295994,449326618
245,"Pearl Harbor",2001,198539855,250700000,449239855
246,"Tarzan",1999,171091819,277100000,448191819
247,"The Bourne Ultimatum",2007,227471070,216572326,444043396
248,"Alvin and the Chipmunks: The Squeakquel",2009,219614612,223868601,443483213
249,"Les Miserables",2012,148809770,293359282,442169052
250,"Men in Black 2",2002,190418803,251349000,441767803
251,"Mrs. Doubtfire",1993,219195051,222090952,441286003
252,"The Mummy Returns",2001,202007640,233032755,435040395
253,"A Star is Born",2018,215288866,218559151,433848017
254,"Terminator 3: Rise of the Machines",2003,150358296,282700000,433058296
255,"Pretty Woman",1990,178406268,254239604,432645872
256,"Terminator: Genisys",2015,89760956,342389938,432150894
257,"Die Another Day",2002,160942139,271000000,431942139
258,"The King’s Speech",2010,138797449,292023719,430821168
259,"The Exorcist",1973,230347346,197867132,428214478
260,"Rampage",2018,101028233,327028047,428056280
261,"The Matrix Revolutions",2003,139270910,288029350,427300260
262,"Cast Away",2000,233632142,193598374,427230516
263,"La La Land",2016,151101803,275422363,426524166
264,"Warcraft",2016,47225655,378296626,425522281
265,"Dances with Wolves",1990,184208842,239991158,424200000
266,"The Chronicles of Narnia: The Voyage of the Daw…",2010,104386950,313800000,418186950
267,"The Chronicles of Narnia: Prince Caspian",2008,141621490,275719798,417341288
268,"The Wolverine",2013,132556852,283900000,416456852
269,"The Mummy",1999,155385488,261000000,416385488
270,"Jason Bourne",2016,162192920,253975396,416168316
271,"Sex and the City",2008,152647258,262600000,415247258
272,"Rain Man",1988,172825435,239974565,412800000
273,"Batman",1989,251188924,160160000,411348924
274,"Pacific Rim",2013,101802906,309200000,411002906
275,"The Bodyguard",1992,121945720,288953319,410899039
276,"The Mummy",2017,80101125,329852780,409953905
277,"Kingsman: The Golden Circle",2017,100234838,308568858,408803696
278,"Signs",2002,227969295,180300000,408269295
279,"X-Men 2",2003,214949694,191925842,406875536
280,"The Mummy: Tomb of the Dragon Emperor",2008,102491776,303268449,405760225
281,"Kingsman: The Secret Service",2015,128261724,276300000,404561724
282,"Alita: Battle Angel",2019,85512761,317265826,402778587
283,"Prometheus",2012,126477084,275971181,402448265
284,"Twilight",2008,192769854,209510305,402280159
285,"Night at the Museum: Battle of the Smithsonian",2009,177243721,224987342,402231063
286,"Ice Age: Collision Course",2016,64063008,338093674,402156682
287,"Snow White and the Huntsman",2012,155136755,245884991,401021746
288,"Tron: Legacy",2010,172062763,228000000,400062763
289,"Mission: Impossible III",2006,133501348,264000000,397501348
290,"Solo: A Star Wars Story",2018,213767512,179383835,393151347
291,"Mamma Mia: Here We Go Again!",2018,120634935,271824610,392459545
292,"Gone with the Wind",1939,198680470,191844722,390525192
293,"Robin Hood: Prince of Thieves",1991,165493908,225006092,390500000
294,"The Wolf of Wall Street",2013,116900694,272969720,389870414
295,"Grease",1978,181813770,205696409,387510179
296,"Star Trek",2009,257730019,129109595,386839614
297,"The Greatest Showman",2017,174340174,212325376,386665550
298,"Ice Age",2002,176387405,209728938,386116343
299,"Home",2015,177397510,208600386,385997896
300,"Back to the Future",1985,212259762,173265022,385524784
301,"Happy Feet",2006,198000317,187000000,385000317
302,"Slumdog Millionaire",2008,141330703,243199737,384530440
303,"Independence Day: Resurgence",2016,103144286,281025138,384169424
304,"Cars 3",2017,152901115,230648036,383549151
305,"Live Free or Die Hard",2007,134529403,247758744,382288147
306,"Monsters vs. Aliens",2009,198351526,183335854,381687380
307,"Fifty Shades Darker",2017,114434010,266964482,381398492
308,"Hotel Transylvania",2012,148313048,230192764,378505812
309,"Taken 2",2012,139854287,237953117,377807404
310,"Godzilla",1998,136314294,239685706,376000000
311,"G.I. Joe: Retaliation",2013,122523060,253217645,375740705
312,"My Big Fat Greek Wedding",2002,241438208,133451826,374890034
313,"X-Men Origins: Wolverine",2009,179883157,194942603,374825760
314,"Spider-Man: Into The Spider-Verse 3D",2018,190173195,184514881,374688076
315,"What Women Want",2000,182805123,191300000,374105123
316,"Superman Returns",2006,200120000,173965065,374085065
317,"The Adventures of Tintin",2011,77591831,296402120,373993951
318,"Shark Tale",2004,161412000,210505043,371917043
319,"Fifty Shades Freed",2018,100407760,270942859,371350619
320,"Captain America: The First Avenger",2011,176654505,193915271,370569776
321,"Edge of Tomorrow",2014,100206256,270335000,370541256
322,"Mad Max: Fury Road",2015,153636354,216461666,370098020
323,"There's Something About Mary",1998,176484651,193400000,369884651
324,"Gone Girl",2014,167767189,200800000,368567189
325,"Raiders of the Lost Ark",1981,225686079,141766000,367452079
326,"The Golden Compass",2007,70107728,297154830,367262558
327,"Xi Hong Shi Shou Fu",2018,0,366961920,366961920
328,"Penguins of Madagascar",2014,83350911,283591620,366942531
329,"Hitch",2005,177784257,189000000,366784257
330,"Die Hard: With a Vengeance",1995,100012499,266089167,366101666
331,"Jurassic Park III",2001,181166115,184733885,365900000
332,"Terminator Salvation",2009,125322469,240169323,365491792
333,"True Lies",1994,146282411,219017589,365300000
334,"Toy Story",1995,191796233,172749283,364545516
335,"Notting Hill",1999,116089678,247638407,363728085
336,"The Nun",2018,117450119,246226328,363676447
337,"A Bug's Life",1998,162798565,200296754,363095319
338,"Fast & Furious",2009,155064265,208000000,363064265
339,"Ocean's Twelve",2004,125531634,237457442,362989076
340,"Alvin and the Chipmunks",2007,217326974,145278059,362605033
341,"Planet of the Apes",2001,180011740,182200000,362211740
342,"The Hangover 3",2013,112200072,249800000,362000072
343,"The World is Not Enough",1999,126930660,234800000,361730660
344,"Zhuo yao ji 2",2018,706153,360977662,361683815
345,"Kimi no na wa",2016,5000181,356023831,361024012
346,"Zhuo yao ji",2015,32766,359462825,359495591
347,"Batman Begins",2005,205343774,153798948,359142722
348,"Home Alone 2: Lost in New York",1992,173585516,185409334,358994850
349,"Minority Report",2002,132024714,226800000,358824714
350,"The Flintstones",1994,130531208,227968792,358500000
351,"Top Gun",1986,179800601,176999033,356799634
352,"Goldeneye",1995,106429941,250000000,356429941
353,"American Beauty",1999,130058047,226200000,356258047
354,"Dinosaur",2000,137748063,218400000,356148063
355,"Catch Me if You Can",2002,164606800,191005491,355612291
356,"X-Men: First Class",2011,146408305,209000000,355408305
357,"Night at the Museum: Secret of the Tomb",2014,113746621,240010000,353756621
358,"The Fugitive",1993,183875760,169839557,353715317
359,"Noah",2014,101200044,251631021,352831065
360,"Basic Instinct",1992,117727224,234972776,352700000
361,"The Angry Birds Movie",2016,107509366,244818521,352327887
362,"The Karate Kid",2010,176591618,175183320,351774938
363,"The Mask",1994,119920129,231700000,351620129
364,"Who Framed Roger Rabbit?",1988,154112492,197387508,351500000
365,"The Great Gatsby",2013,144840419,206200000,351040419
366,"Doctor Seuss' The Lorax",2012,214030500,136946253,350976753
367,"Hannibal",2001,165092266,185008014,350100280
368,"Deep Impact",1998,140464664,209000000,349464664
369,"Alvin and the Chipmunks: Chipwrecked",2011,133107389,215981134,349088523
370,"The Legend of Tarzan",2016,126643061,222258964,348902025
371,"I, Robot",2004,144801023,203828562,348629585
372,"The Smurfs 2",2013,71017784,277529739,348547523
373,"The Maze Runner",2014,102427862,245891999,348319861
374,"Rush Hour 2",2001,226164286,121261546,347425832
375,"Peter Rabbit",2018,115234093,231902384,347136477
376,"Pocahontas",1995,141579773,205520227,347100000
377,"Murder on the Orient Express",2017,102826543,243096187,345922730
378,"How the Grinch Stole Christmas",2000,260044825,85096578,345141403
379,"xXx: Return of Xander Cage",2017,44898413,300134946,345033359
380,"Mary Poppins Returns",2018,171958438,172327497,344285935
381,"Trolls",2016,153707064,190365169,344072233
382,"Over the Hedge",2006,155019340,188377907,343397247
383,"Now You See Me",2013,117723989,225045211,342769200
384,"Wanted",2008,134508551,207907909,342416460
385,"Close Encounters of the Third Kind",1977,169100479,171700000,340800479
386,"Enchanted",2007,127706877,212677264,340384141
387,"Tomorrow Never Dies",1997,125304276,214200000,339504276
388,"Batman Forever",1995,184031112,152498032,336529144
389,"Prince of Persia: Sands of Time",2010,90759676,245600000,336359676
390,"The Rock",1996,134069511,202000000,336069511
391,"Apollo 13",1995,173772767,162029504,335802271
392,"Star Trek Beyond",2016,158848340,176953893,335802233
393,"Never Say Die",2017,0,334536622,334536622
394,"A Quiet Place",2018,188024361,146497933,334522294
395,"The Great Wall",2016,45157105,289329747,334486852
396,"The Good Dinosaur",2015,123087120,210683917,333771037
397,"Fantastic Four",2005,154696080,178436670,333132750
398,"Indiana Jones and the Temple of Doom",1984,179880271,153200000,333080271
399,"Back to the Future Part II",1989,118450002,213549998,332000000
400,"22 Jump Street",2014,191719337,139614539,331333876
401,"National Treasure",2004,173005002,158318408,331323410
402,"Black Swan",2010,106954678,224312032,331266710
403,"300: Rise of an Empire",2014,106580051,224200000,330780051
404,"Meet the Parents",2000,166225040,164200000,330425040
405,"The Curious Case of Benjamin Button",2008,127509326,202122632,329631958
406,"The Perfect Storm",2000,182618434,146093000,328711434
407,"Now You See Me 2",2016,65075540,263249467,328325007
408,"Crocodile Dundee",1986,174803506,153400000,328203506
409,"Se7en",1995,100125643,228000000,328125643
410,"Bolt",2008,114053579,213961450,328015029
411,"Taken 3",2015,89256424,238400000,327656424
412,"Feng Kuang De Wai Xing Ren",2019,0,326150303,326150303
413,"The Devil Wears Prada",2006,124740460,201332695,326073155
414,"The Hunchback of Notre Dame",1996,100138851,225361149,325500000
415,"Shazam!",2019,121341951,201500000,322841951
416,"Robin Hood",2010,105487148,216971858,322459006
417,"Schindler’s List",1993,96898818,225298314,322197132
418,"Megamind",2010,148415853,173471355,321887208
419,"Fatal Attraction",1987,156645693,163454307,320100000
420,"The Last Airbender",2010,131772187,187941694,319713881
421,"Lethal Weapon 3",1992,144731527,174968473,319700000
422,"Journey 2: The Mysterious Island",2012,103860290,214285872,318146162
423,"The Conjuring",2013,137400141,180600000,318000141
424,"A Beautiful Mind",2001,170708996,146959062,317668058
425,"Inglourious Basterds",2009,120774594,196140670,316915264
426,"Beverly Hills Cop",1984,234760478,81539522,316300000
427,"Disney’s A Christmas Carol",2009,137855863,177853834,315709697
428,"Green Book",2018,85017316,230350980,315368296
429,"Air Force One",1997,172956409,142311944,315268353
430,"The Proposal",2009,163958031,150751686,314709717
431,"As Good as it Gets",1997,148478011,165633912,314111923
432,"Resident Evil: The Final Chapter",2016,26844692,287256498,314101190
433,"Battleship",2012,65233400,248244317,313477717
434,"Austin Powers: The Spy Who Shagged Me",1999,206040085,106343402,312383487
435,"The Expendables 2",2012,85028192,226951064,311979256
436,"Ocean's Thirteen",2007,117144465,194600000,311744465
437,"The Polar Express",2004,187224605,124140582,311365187
438,"The Conjuring 2: The Enfield Poltergeist",2016,102470008,208792094,311262102
439,"The SpongeBob Movie: Sponge Out of Water",2015,162994032,148019149,311013181
440,"The Bourne Supremacy",2004,176087450,134913674,311001124
441,"The Lego Batman Movie",2017,175750384,134909634,310660018
442,"Little Fockers",2010,148438600,162211974,310650574
443,"Maze Runner: The Scorch Trials",2015,81697192,228868970,310566162
444,"Runaway Bride",1999,152257509,157880669,310138178
445,"Chicken Little",2005,135386665,174657158,310043823
446,"Ransom",1996,136492681,172207319,308700000
447,"Dumbo",2019,101254910,206600000,307854910
448,"Qian Ren 3: Yan Zhi Da Zuo Zhan",2017,837791,306710033,307547824
449,"The Pursuit of Happyness",2006,162586036,144725057,307311093
450,"The Fault in Our Stars",2014,124872350,182294484,307166834
451,"Rise of the Guardians",2012,103412758,203488144,306900902
452,"Chicago",2002,170687518,136083027,306770545
453,"The Blind Side",2009,255959475,49746319,305705794
454,"Annabelle: Creation",2017,102092201,203292664,305384865
455,"Wrath of the Titans",2012,83670083,221600000,305270083
456,"Wonder",2017,132422809,172181903,304604712
457,"A Good Day to Die Hard",2013,67349198,236900000,304249198
458,"101 Dalmatians",1996,136189294,168010706,304200000
459,"Skyscraper",2018,68420120,235695414,304115534
460,"Mulan",1998,120620254,182879746,303500000
461,"Liar Liar",1997,181410615,121300000,302710615
462,"G.I. Joe: The Rise of Cobra",2009,150201498,152267519,302469017
463,"Passengers",2016,100014699,202224973,302239672
464,"Hook",1991,119654823,181200000,300854823
465,"Rambo: First Blood Part II",1985,150415432,149984568,300400000
466,"Rocky IV",1985,127873716,172500000,300373716
467,"Superman",1978,134218018,165981982,300200000
468,"Van Helsing",2004,120150546,180000000,300150546
469,"Horton Hears a Who",2008,154529439,144948447,299477886
470,"Shutter Island",2010,128012934,171448848,299461782
471,"My Best Friend's Wedding",1997,126813153,172110266,298923419
472,"Stuart Little",1999,140015224,158800000,298815224
473,"Ocean’s 8",2018,140218711,156897265,297115976
474,"Look Who's Talking",1989,140088813,157011187,297100000
475,"X-Men",2000,157299717,139572650,296872367
476,"Austin Powers in Goldmember",2002,213117789,83220874,296338663
477,"Miss Peregrine’s Home for Peculiar Children",2016,87242834,208744042,295986876
478,"Resident Evil: Afterlife",2010,60128566,235745624,295874190
479,"Ghostbusters",1984,242212467,53000000,295212467
480,"The Divergent Series: Insurgent",2015,130179072,164896810,295075882
481,"Sex and the City 2",2010,95347692,199333086,294680778
482,"Dangal",2016,12391761,282262857,294654618
483,"Doctor Dolittle",1998,144156605,150000000,294156605
484,"G-Force",2009,119436770,173381071,292817841
485,"Pacific Rim: Uprising",2018,59874525,231055623,290930148
486,"The Green Mile",1999,136801374,153900000,290701374
487,"Salt",2010,118311368,172339126,290650494
488,"Ferdinand",2017,84410380,205448783,289859163
489,"The Departed",2006,132384315,157276304,289660619
490,"Bridesmaids",2011,169211718,120420305,289632023
491,"Fantastic Four: Rise of the Silver Surfer",2007,131921738,157558953,289480691
492,"Coming to America",1988,128152301,160647699,288800000
493,"What Lies Beneath",2000,155464351,133229638,288693989
494,"Oblivion",2013,89107235,198809398,287916633
495,"Pitch Perfect 2",2015,184296230,103329238,287625468
496,"Bee Movie",2007,126631277,160963300,287594577
497,"Turbo",2013,83028130,203868448,286896578
498,"American Pie 2",2001,145096820,141403180,286500000
499,"The Sound of Music",1965,163214286,123000000,286214286
500,"Elysium",2013,93050117,193141974,286192091
501,"Lethal Weapon 4",1998,130444603,154955397,285400000
502,"Wedding Crashers",2005,209218368,74000000,283218368
503,"Speed",1994,121248145,161951855,283200000
504,"John Carter",2012,73058679,209719421,282778100
505,"Saturday Night Fever",1977,139486124,142913876,282400000
506,"Casper",1995,100328194,181971806,282300000
507,"Bridget Jones's Diary",2001,71500556,210026602,281527158
508,"The Bourne Legacy",2012,113203870,167152050,280355920
509,"Shakespeare in Love",1998,100317794,179182206,279500000
510,"Split",2017,138141585,140823221,278964806
511,"The Tourist",2010,67631157,211100212,278731369
512,"Scary Movie",2000,157019771,120180229,277200000
513,"Alice Through the Looking Glass",2016,77042381,199885731,276928112
514,"Beverly Hills Cop II",1987,153665036,123000000,276665036
515,"Scooby-Doo",2002,153294164,123000000,276294164
516,"Divergent",2014,150947895,125067070,276014965
517,"The Silence of the Lambs",1991,130726716,145000000,275726716
518,"Sen to Chihiro no Kamikakushi",2002,10049886,264900000,274949886
519,"Gran Torino",2008,148095302,126447783,274543085
520,"High School Musical 3: Senior Year",2008,90559416,183833464,274392880
521,"Cloudy with a Chance of Meatballs 2",2013,119793567,154599082,274392649
522,"Jerry Maguire",1996,153952592,120047408,274000000
523,"The Nutty Professor",1996,128814019,145000000,273814019
524,"Tomb Raider",2018,58250803,215226698,273477501
525,"Lincoln",2012,182207973,91138308,273346281
526,"Lara Croft: Tomb Raider",2001,131144183,142186002,273330185
527,"Bad Boys II",2003,138540870,134731112,273271982
528,"Grown Ups",2010,162001186,110222244,272223430
529,"The Princess and the Frog",2009,104400899,166596479,270997378
530,"Neighbors",2014,150086800,120857628,270944428
531,"The Firm",1993,158340892,112000000,270340892
532,"Mr. Peabody & Sherman",2014,111506430,158300000,269806430
533,"10,000 B.C.",2008,94784201,174281477,269065678
534,"The Godfather",1972,134966411,133533589,268500000
535,"Exodus: Gods and Kings",2014,65014513,203300000,268314513
536,"The Expendables",2010,103068524,165199650,268268174
537,"Bambi",1942,102797000,165203000,268000000
538,"American Gangster",2007,130164645,137820811,267985456
539,"We're the Millers",2013,150394119,117422157,267816276
540,"xXx",2002,141930000,125270000,267200000
541,"Batman Returns",1992,162833635,103990656,266824291
542,"Something's Gotta Give",2003,124685242,142000000,266685242
543,"Indecent Proposal",1993,106614059,159985941,266600000
544,"Maze Runner: The Death Cure",2018,58032443,207846093,265878536
545,"The Incredible Hulk",2008,134806913,130766946,265573859
546,"Waterworld",1995,88246220,176000000,264246220
547,"The Truman Show",1998,125618201,138500000,264118201
548,"The Fifth Element",1997,63570862,200327899,263898761
549,"Bridget Jones: The Edge Of Reason",2004,40203020,223691531,263894551
550,"Real Steel",2011,85463309,178417032,263880341
551,"Cinderella",1950,85000000,178591415,263591415
552,"Baahubali 2: The Conclusion",2017,18985794,244517120,263502914
553,"Epic",2013,107518682,155275759,262794441
554,"Jumanji",1995,100458310,162300000,262758310
555,"Borat",2006,128505958,132937284,261443242
556,"Total Recall",1990,119394839,142005161,261400000
557,"The Full Monty",1997,45950122,215299261,261249383
558,"Robots",2005,128200012,132500000,260700012
559,"The Lone Ranger",2013,89302115,170700000,260002115
560,"Charlie's Angels",2000,125305545,134430545,259736090
561,"Blade Runner 2049",2017,92054159,167303249,259357408
562,"Paddington",2014,76223578,182565519,258789097
563,"Knight and Day",2010,76423035,182328335,258751370
564,"Out of Africa",1985,79096868,179113992,258210860
565,"Super 8",2011,127004179,130968566,257972745
566,"American Hustle",2013,150117807,107760487,257878294
567,"Erin Brockovich",2000,125548685,132256558,257805243
568,"The Village",2004,114197520,143444114,257641634
569,"Annabelle",2014,84273813,172589107,256862920
570,"Rush Hour 3",2007,140125968,116459914,256585882
571,"Bean",1997,45334169,211239959,256574128
572,"Gong fu yu jia",2017,362657,255641470,256004127
573,"The Taking of Tiger Mountain",2014,222964,255759969,255982933
574,"Fei Chi Ren Sheng",2019,0,255832826,255832826
575,"Get Out",2017,176040665,79327286,255367951
576,"Cliffhanger",1993,84049211,170950789,255000000
577,"Halloween",2018,159342015,95000000,254342015
578,"Wild Hogs",2007,168213584,85341799,253555383
579,"True Grit",2010,171243005,81033923,252276928
580,"Michael Jackson's This Is It",2009,72091016,180000000,252091016
581,"After Earth",2013,60522097,190977568,251499665
582,"You've Got Mail",1998,115821495,134978505,250800000
583,"Hercules",1997,99112101,151587899,250700000
584,"Enemy of the State",1998,111549836,139100000,250649836
585,"Brother Bear",2003,85336277,165061521,250397798
586,"Space Jam",1996,90463534,159736466,250200000
587,"The Peanuts Movie",2015,130178411,119913199,250091610
588,"Alvin and the Chipmunks: The Road Chip",2015,85886987,163630969,249517956
589,"Eragon",2006,75030163,174457952,249488115
590,"Xi You Fu Yao Pian",2017,880346,247924803,248805149
591,"The Ghouls",2015,1243810,247448912,248692722
592,"Love Actually",2003,59472278,189033022,248505300
593,"The Blair Witch Project",1999,140539099,107760901,248300000
594,"The Ring",2002,129094024,119124462,248218486
595,"Unbreakable",2000,94999143,153100000,248099143
596,"Marley & Me",2008,143153751,104658260,247812011
597,"Bienvenue chez les Ch'tis",2008,1477650,245996847,247474497
598,"Grown Ups 2",2013,133668525,113355283,247023808
599,"Dumb & Dumber",1994,127175374,119224626,246400000
600,"Babe",1995,63658910,182441090,246100000
601,"Lilo & Stitch",2002,145771527,100028473,245800000
602,"8 Mile",2002,116724075,129044309,245768384
603,"Us",2019,170444620,75300000,245744620
604,"Rango",2011,123477607,122246993,245724600
605,"Teenage Mutant Ninja Turtles: Out of the Shadows",2016,82051601,163276773,245328374
606,"Glass",2019,111035005,134268500,245303505
607,"Rush Hour",1998,141186864,104113136,245300000
608,"Hulk",2003,132177234,112898200,245075434
609,"Back to the Future Part III",1990,88055283,156033371,244088654
610,"Pixels",2015,78765986,165275818,244041804
611,"Hercules",2014,72688614,170700000,243388614
612,"Journey to the Center of the Earth",2008,101704370,141476567,243180937
613,"RoboCop",2014,58607007,184374792,242981799
614,"Four Weddings and a Funeral",1994,52700832,190194977,242895809
615,"Daddy’s Home",2015,150357137,92400000,242757137
616,"Face/Off",1997,112276146,128923854,241200000
617,"Assassin’s Creed",2016,54647948,186111734,240759682
618,"Resident Evil: Retribution",2012,42345531,198302098,240647629
619,"Die Hard 2",1990,117323878,122490147,239814025
620,"Crocodile Dundee 2",1988,109306210,130300000,239606210
621,"Dead Poets Society",1989,95860116,143639884,239500000
622,"The Girl with the Dragon Tattoo",2011,102515793,136858177,239373970
623,"Grand Canyon: The Hidden Secrets",1984,52800000,186200000,239000000
624,"Sully",2016,125070033,113454523,238524556
625,"Alien: Covenant",2017,74262031,164259216,238521247
626,"Batman & Robin",1997,107325195,130992619,238317814
627,"Dark Shadows",2012,79727149,158475519,238202668
628,"Crazy Rich Asians",2018,174532921,63566790,238099711
629,"Disney Planes",2013,90282580,147776989,238059569
630,"Hauru no ugoku shiro",2005,4710455,233103872,237814327
631,"Click",2006,137355633,100329456,237685089
632,"The Day the Earth Stood Still",2008,79366978,158003372,237370350
633,"Gang jiong",2015,1302281,235971100,237273381
634,"Cloudy with a Chance of Meatballs",2009,124870275,111957402,236827677
635,"American Reunion",2012,56758835,180040376,236799211
636,"A Few Good Men",1992,141340178,95159822,236500000
637,"Silver Linings Playbook",2012,132092958,104319495,236412453
638,"2 Fast 2 Furious",2003,127120058,109290549,236410607
639,"Artificial Intelligence: AI",2001,78616689,157283311,235900000
640,"Mr. Bean’s Holiday",2007,33302167,201679175,234981342
641,"American Pie",1999,101800948,132922200,234723148
642,"Eraser",1996,101295562,133104438,234400000
643,"The Mask of Zorro",1998,93828745,139871255,233700000
644,"Gone in 60 Seconds",2000,101643008,131000000,232643008
645,"Spy!",2015,110825712,121760036,232585748
646,"Gulliver's Travels",2010,42779261,189238587,232017848
647,"Million Dollar Baby",2004,100492203,131436024,231928227
648,"Hidden Figures",2016,169607287,62164429,231771716
649,"The English Patient",1996,78716374,152993634,231710008
650,"Sister Act",1992,139605150,91994850,231600000
651,"Juno",2007,143495265,87954837,231450102
652,"The Heat",2013,159581587,70146187,229727774
653,"Ghost Rider",2007,115802596,113742993,229545589
654,"La vita è bella",1998,57598247,171787114,229385361
655,"The Green Hornet",2011,98780042,130375461,229155503
656,"Ghostbusters",2016,128350574,100658084,229008658
657,"Big Daddy",1999,163479795,65161488,228641283
658,"Baby Driver",2017,107825862,120278323,228104185
659,"Sleepless in Seattle",1993,126680884,101218442,227899326
660,"Chicken Run",2000,106793915,121000000,227793915
661,"The Imitation Game",2014,91125143,136615320,227740463
662,"Lethal Weapon 2",1989,147253986,80046014,227300000
663,"Charlie's Angels: Full Throttle",2003,100814328,126385672,227200000
664,"Argo",2012,136025503,91115254,227140757
665,"Fang Hua",2017,1891956,225197313,227089269
666,"Taken",2009,145000989,81940596,226941585
667,"Get Smart",2008,130319208,96420208,226739416
668,"Yes Man",2008,97690976,128300000,225990976
669,"Good Will Hunting",1997,138433435,87492554,225925989
670,"Rocky",1976,117235147,107764853,225000000
671,"The Social Network",2010,96962694,127959441,224922135
672,"It’s Complicated",2009,112735375,111879369,224614744
673,"Con Air",1997,101117573,123000000,224117573
674,"Interview with the Vampire: The Vampire Chronicles",1994,105264608,118300000,223564608
675,"Percy Jackson & the Olympians: The Lightning Thief",2010,88768303,134282571,223050874
676,"Honey, I Shrunk the Kids",1989,130724172,91975828,222700000
677,"Jumper",2008,80172128,142468684,222640812
678,"Non-Stop",2014,91742160,130640895,222383055
679,"The Little Mermaid",1989,111543479,110756279,222299758
680,"Constantine",2005,75976178,145618733,221594911
681,"Bedtime Stories",2008,110101975,111366960,221468935
682,"Presumed Innocent",1990,86303188,134996812,221300000
683,"Everest",2015,43482270,177814791,221297061
684,"Wild Wild West",1999,113805681,107423654,221229335
685,"Fahrenheit 9/11",2004,119114517,102034442,221148959
686,"Geostorm",2017,33700160,187095849,220796009
687,"Elf",2003,173840591,46837892,220678483
688,"Captain Phillips",2013,107136417,113511767,220648184
689,"Dracula Untold",2014,55991880,164249843,220241723
690,"Green Lantern",2011,116601172,102934320,219535492
691,"Inferno",2016,34343574,185175793,219519367
692,"Knocked Up",2007,148761765,70504187,219265952
693,"Kingdom of Heaven",2005,47398413,171454940,218853353
694,"The Terminal",2004,77073959,141600000,218673959
695,"The Prince of Egypt",1998,101413188,117200000,218613188
696,"What Happens in Vegas...",2008,80277646,138258062,218535708
697,"The Sorcerer's Apprentice",2010,63150991,154835329,217986320
698,"Collateral",2004,100170152,117500000,217670152
699,"Valentine's Day",2010,110485654,107083674,217569328
700,"Jack Reacher",2012,80070736,137300000,217370736
701,"Ted 2",2015,81476385,135737758,217214143
702,"Central Intelligence",2016,127440871,89753934,217194805
703,"Twins",1988,111936388,104663612,216600000
704,"The Emoji Movie",2017,86089513,130479466,216568979
705,"Bram Stoker's Dracula",1992,82522790,133339902,215862692
706,"Ghostbusters II",1989,112494738,103005262,215500000
707,"Bad Teacher",2011,100292856,115156141,215448997
708,"The Patriot",2000,113330342,101969658,215300000
709,"Valerian and the City of a Thousand Planets",2017,40479370,174618986,215098356
710,"Australia",2008,49554002,165526808,215080810
711,"Just Go With It",2011,103028109,111946844,214974953
712,"Hansel & Gretel: Witch Hunters",2013,55703475,159246241,214949716
713,"Flightplan",2005,89706988,124685916,214392904
714,"The Bourne Identity",2002,121468960,92888411,214357371
715,"Dirty Dancing",1987,63892689,150001106,213893795
716,"Smallfoot",2018,83240103,130453506,213693609
717,"Creed II",2018,115715889,97875633,213591522
718,"Crouching Tiger, Hidden Dragon",2000,128067808,85446864,213514672
719,"Vertical Limit",2000,68473360,145026640,213500000
720,"Battle: Los Angeles",2011,83552429,129911547,213463976
721,"Miss Congeniality",2000,106807667,106613284,213420951
722,"The Help",2011,169705587,43414417,213120004
723,"Into the Woods",2014,128002372,85114029,213116401
724,"Lemony Snicket's A Series of Unfortunate Events",2004,118627117,94328907,212956024
725,"Pulp Fiction",1994,107928762,105000000,212928762
726,"Master and Commander: The Far Side of the World",2003,93926386,118985751,212912137
727,"District 9",2009,115646235,96807196,212453431
728,"Horrible Bosses",2011,117538559,94879042,212417601
729,"Ace Ventura: When Nature Calls",1995,108360063,104039937,212400000
730,"Public Enemies",2009,97104620,115178089,212282709
731,"Disclosure",1994,83015089,129184911,212200000
732,"End of Days",1999,66889043,145137932,212026975
733,"Total Recall",2012,58877969,152978119,211856088
734,"Due Date",2010,100539043,111200000,211739043
735,"Entrapment",1999,87707396,123992604,211700000
736,"Xia Luo Te Fan Nao",2015,1289195,210280552,211569747
737,"Immortals",2011,83504017,128058418,211562435
738,"Fury",2014,85817906,124497775,210315681
739,"Moonraker",1979,70300000,140000000,210300000
740,"The Expendables 3",2014,39322544,170138834,209461378
741,"Hou Lai De Wo Men",2018,0,209221328,209221328
742,"Braveheart",1995,75545647,133499597,209045244
743,"Jaws 2",1978,102922376,105978000,208900376
744,"Safe House",2012,126181630,82360532,208542162
745,"The Aviator",2004,102608827,105762065,208370892
746,"Traffic",2000,124107476,84192524,208300000
747,"Me Before You",2016,56245075,152020123,208265198
748,"Garfield: The Movie",2004,75367693,132726857,208094550
749,"Xi you xiang mo pian",2013,18058,207909924,207927982
750,"The Others",2001,96522687,111242369,207765056
751,"Clear and Present Danger",1994,122012656,85487344,207500000
752,"S.W.A.T.",2003,116877597,90277151,207154748
753,"Sleepy Hollow",1999,101068340,106000000,207068340
754,"Paranormal Activity 3",2011,104028807,103011037,207039844
755,"Tomorrowland",2015,93436322,113191196,206627518
756,"Eat Pray Love",2010,80574010,126024779,206598789
757,"The Fast and the Furious",2001,144512310,62000000,206512310
758,"Red Dragon",2002,92955420,113500000,206455420
759,"Bridget Jones’s Baby",2016,24139805,181682883,205822688
760,"The Break-Up",2006,118703275,87024032,205727307
761,"White House Down",2013,73103784,132336603,205440387
762,"JFK",1991,70405498,134994502,205400000
763,"Ren zai jiong tu zhi tai jiong",2012,0,205400000,205400000
764,"Gake no ue no Ponyo",2009,15090399,190222267,205312666
765,"The Ugly Truth",2009,88915214,116383693,205298907
766,"The Holiday",2006,63280000,141910324,205190324
767,"Yogi Bear",2010,100246011,104528679,204774690
768,"Valkyrie",2008,83107829,120824345,203932174
769,"King Arthur",2004,51877963,152000000,203877963
770,"A Dog’s Purpose",2017,64321890,139349735,203671625
771,"Alien",1979,80930630,122700000,203630630
772,"Arrival",2016,100546139,102581755,203127894
773,"Hairspray",2007,118871849,84163723,203035572
774,"Fun With Dick And Jane",2005,110550000,92468919,203018919
775,"You Don't Mess With the Zohan",2008,100018837,102892154,202910991
776,"21 Jump Street",2012,138447667,64364762,202812429
777,"Vanilla Sky",2001,100614858,102111747,202726605
778,"Straight Outta Compton",2015,161197785,40985196,202182981
779,"Patch Adams",1998,135014968,67158032,202173000
780,"Teenage Mutant Ninja Turtles",1990,135265915,66734085,202000000
781,"Kindergarten Cop",1990,91457688,110542312,202000000
782,"Flashdance",1983,90463574,111000000,201463574
783,"Philadelphia",1993,77324422,124000000,201324422
784,"Percy Jackson: Sea of Monsters",2013,68559554,132300000,200859554
785,"Cats & Dogs",2001,93375151,107324849,200700000
786,"The Hunt for Red October",1990,120709866,79790134,200500000
787,"Rocky 2",1979,85182160,115000000,200182160
788,"The BFG",2016,55483770,144162910,199646680
789,"Two Weeks Notice",2002,93354918,105688391,199043309
790,"City of Angels",1998,78750909,120000000,198750909
791,"Yi Chu Hao Xi",2018,670883,197659887,198330770
792,"The Pacifier",2005,113006880,85000000,198006880
793,"Spy Kids",2001,112692062,85000000,197692062
794,"Jack the Giant Slayer",2013,65187603,132500000,197687603
795,"The Vow",2012,125014030,72604130,197618160
796,"Wallace & Gromit: The Curse of the Were-Rabbit",2005,56068547,141524605,197593152
797,"Smurfs: The Lost Village",2017,45020282,152558304,197578586
798,"Christopher Robin",2018,99215042,98289716,197504758
799,"The Intern",2015,75764672,121351038,197115710
800,"Stargate",1994,71565669,125000000,196565669
801,"Red",2010,90380162,106059531,196439693
802,"50 First Dates",2004,120776832,75543497,196320329
803,"Panic Room",2002,95308367,101000000,196308367
804,"Anger Management",2003,135560942,60100000,195660942
805,"For Your Eyes Only",1981,54800000,140500000,195300000
806,"London Has Fallen",2016,62524260,132669825,195194085
807,"The Other Woman",2014,83911193,111200000,195111193
808,"Beowulf",2007,82280579,112800000,195080579
809,"Paranormal Activity",2009,107918810,86264224,194183034
810,"Need for Speed",2014,43568507,150601112,194169619
811,"Xi You Ji zhi Sun Wu Kong San Da Bai Gu Jing",2016,709982,193348521,194058503
812,"Gnomeo and Juliet",2011,99967670,93770307,193737977
813,"Paddington 2",2017,40891591,152702483,193594074
814,"The Sum of All Fears",2002,118471320,75028680,193500000
815,"The Equalizer",2014,101530738,91372886,192903624
816,"Open Season",2006,85105259,106826899,191932158
817,"The Longest Yard",2005,158119460,33439045,191558505
818,"The Addams Family",1991,113502246,78000000,191502246
819,"The Living Daylights",1987,51185000,140015000,191200000
820,"Hollow Man",2000,73209340,117990660,191200000
821,"Tropic Thunder",2008,110515313,80629943,191145256
822,"The Equalizer 2",2018,102084362,88368770,190453132
823,"Cheaper by the Dozen",2003,138614544,51597569,190212113
824,"The Waterboy",1998,161491646,28700000,190191646
825,"Outbreak",1995,67823573,122200000,190023573
826,"The Santa Clause",1994,144833357,44966643,189800000
827,"Mr. Poppers's Penguins",2011,68224452,121400000,189624452
828,"The Shape of Water",2017,63859435,125335785,189195220
829,"The X Files: Fight the Future",1998,83898313,105278110,189176423
830,"Xin Hua Lu Fang",2014,774961,187970000,188744961
831,"Rambo III",1988,53715611,135000000,188715611
832,"Hop",2011,108085305,80572288,188657593
833,"The Pelican Brief",1993,100768056,87227803,187995859
834,"The Secret Life of Walter Mitty",2013,58236838,129624345,187861183
835,"Walk the Line",2005,119519402,68188093,187707495
836,"Octopussy",1983,67900000,119600000,187500000
837,"Heat",1995,67436818,119998952,187435770
838,"The Final Destination",2009,66477700,120906927,187384627
839,"In the Line of Fire",1993,102243874,85100000,187343874
840,"The Grudge",2004,110359362,76921753,187281115
841,"Watchmen",2009,107509799,79466451,186976250
842,"The Horse Whisperer",1998,75383563,111500000,186883563
843,"The LEGO Movie 2: The Second Part",2019,105417947,81366433,186784380
844,"Knowing",2009,79957634,106492683,186450317
845,"Atlantis: The Lost Empire",2001,84052762,101996258,186049020
846,"Wu Shuang",2018,0,186027770,186027770
847,"Paul Blart: Mall Cop",2009,146336178,39568572,185904750
848,"Inside Man",2006,88634237,97164028,185798265
849,"Pitch Perfect 3",2017,104897530,80838882,185736412
850,"I Now Pronounce You Chuck and Larry",2007,119725280,65983182,185708462
851,"The Spy Who Loved Me",1977,46800000,138600000,185400000
852,"Snow White and the Seven Dwarfs",1937,184925486,0,184925486
853,"Road to Perdition",2002,104054514,79300000,183354514
854,"Storks",2016,72679278,110674153,183353431
855,"Aliens",1986,85160248,98156207,183316455
856,"Gangs of New York",2002,77730500,105394121,183124621
857,"Wayne's World",1992,121697323,61400000,183097323
858,"Maverick",1994,101631272,81383965,183015237
859,"Daredevil",2003,102543518,80239000,182782518
860,"Du cheng feng yun III",2016,0,182579909,182579909
861,"Sweet Home Alabama",2002,127214072,55151042,182365114
862,"Cape Fear",1991,79091969,103200000,182291969
863,"While You Were Sleeping",1995,81057016,101000000,182057016
864,"Jupiter Ascending",2015,47482519,134500000,181982519
865,"The Birdcage",1996,124060553,57700000,181760553
866,"Poseidon",2006,60674817,121000000,181674817
867,"The First Wives Club",1996,105489203,76000000,181489203
868,"Scooby-Doo 2: Monsters Unleashed",2004,84185387,97000000,181185387
869,"He's Just Not That Into You",2009,93953653,87100004,181053657
870,"Déjà Vu",2006,64038616,117000000,181038616
871,"12 Years a Slave",2013,56671993,124353350,181025343
872,"Bad Moms",2016,113257297,67741419,180998716
873,"Eagle Eye",2008,101440743,79144516,180585259
874,"The Haunting",1999,91188905,89000000,180188905
875,"The Dictator",2012,59650222,120498675,180148897
876,"Hugo",2011,73864507,106183277,180047784
877,"The Post",2017,81903458,97845422,179748880
878,"Flushed Away",2006,64665672,114691454,179357126
879,"The League of Extraordinary Gentlemen",2003,66465204,112800000,179265204
880,"Moulin Rouge",2001,57386369,121814219,179200588
881,"Dangerous Minds",1995,84919401,94000000,178919401
882,"How to Lose a Guy in 10 Days",2003,105807520,73083262,178890782
883,"Scary Movie 4",2006,90710620,88000000,178710620
884,"Dante's Peak",1997,67163857,111036143,178200000
885,"Patriot Games",1992,83287363,94812637,178100000
886,"Flubber",1997,92993801,85000000,177993801
887,"Double Jeopardy",1999,116735231,61100000,177835231
888,"Jet Li's Hero",2004,53652140,123883818,177535958
889,"Paranormal Activity 2",2010,84752907,92759125,177512032
890,"The 40 Year-old Virgin",2005,109449237,67894993,177344230
891,"The A-Team",2010,77222099,100019072,177241171
892,"Tootsie",1982,177200000,0,177200000
893,"Lee Daniels' The Butler",2013,116632095,60393403,177025498
894,"Brokeback Mountain",2005,83043761,93937102,176980863
895,"Analyze This",1999,106885658,70000000,176885658
896,"Kill Bill: Volume 1",2003,70098138,106371290,176469428
897,"Hot Shots!",1991,68267322,108000000,176267322
898,"The Italian Job",2003,106126012,70136827,176262839
899,"Dr. Dolittle 2",2001,112950721,63151000,176101721
900,"Cowboys and Aliens",2011,100368560,75669764,176038324
901,"Baywatch",2017,58060186,117803597,175863783
902,"Daddy’s Home 2",2017,104029443,71777740,175807183
903,"The Bridges of Madison County",1995,71516617,104000000,175516617
904,"The Descendants",2011,82624961,92882839,175507800
905,"Identity Thief",2013,134506920,40854658,175361578
906,"Sleeping with the Enemy",1991,101599005,73369937,174968942
907,"The Bucket List",2007,93466502,81340943,174807445
908,"George Of The Jungle",1997,105263257,69200000,174463257
909,"The Girl on the Train",2016,75395035,98883179,174278214
910,"Le Fabuleux destin d'Amélie Poulain",2001,33201661,141000000,174201661
911,"Evan Almighty",2007,100289690,73841639,174131329
912,"Operation Mekong",2016,800012,173057000,173857012
913,"Mirror Mirror",2012,64935167,108678315,173613482
914,"Creed",2015,109767581,63800000,173567581
915,"Big Momma's House",2000,117559438,56000000,173559438
916,"Scream",1996,103046663,70000000,173046663
917,"Along Came Polly",2004,88073507,84970903,173044410
918,"The Santa Clause 2",2002,139225854,33600000,172825854
919,"The Hitman’s Bodyguard",2017,75468583,97310084,172778667
920,"AVP: Alien Vs. Predator",2004,80281096,92262423,172543519
921,"Couples Retreat",2009,109205660,63244763,172450423
922,"Scream 2",1997,101363301,71000000,172363301
923,"Anchorman 2: The Legend Continues",2013,127352707,44833047,172185754
924,"The Divergent Series: Allegiant",2016,66184051,105838466,172022517
925,"Jackass 3D",2010,117229692,54456101,171685793
926,"Blood Diamond",2006,57377916,114000000,171377916
927,"John Wick: Chapter Two",2017,92029184,79320825,171350009
928,"Cloverfield",2008,80048433,91253793,171302226
929,"Mr. Deeds",2002,126293452,44976083,171269535
930,"The Mule",2018,103804407,67300000,171104407
931,"The Other Guys",2010,119219978,51716492,170936470
932,"Zookeeper",2011,80360866,90444659,170805525
933,"Meet the Robinsons",2007,97822171,72730548,170552719
934,"Magic Mike",2012,113721571,56828182,170549753
935,"Looper",2012,66486205,103980200,170466405
936,"The Nutcracker and the Four Realms",2018,54858851,115435048,170293899
937,"Starsky & Hutch",2004,88200225,82000000,170200225
938,"Shi Er Sheng Xiao",2012,0,169994606,169994606
939,"Superbad",2007,121463226,48491916,169955142
940,"Jian Bing Man",2015,0,169842267,169842267
941,"The Impossible",2012,19019882,150570724,169590606
942,"The Saint",1997,61363304,108036696,169400000
943,"The Emperor's New Groove",2000,89296573,80000000,169296573
944,"Hannah Montana the Movie",2009,79576189,89597017,169173206
945,"Hacksaw Ridge",2016,67209615,101695067,168904682
946,"12 Monkeys",1995,57141459,111700000,168841459
947,"Four Christmases",2008,120146040,48165518,168311558
948,"Burn After Reading",2008,60355347,107812451,168167798
949,"Focus",2015,53862963,114202737,168065700
950,"Ghost in the Shell",2017,40563557,127347133,167910690
951,"Insidious: The Last Key",2018,67745330,100140258,167885588
952,"Spy Kids 3-D: Game Over",2003,111760631,56091364,167851995
953,"Fantastic Four",2015,56117548,111731639,167849187
954,"Xi you ji: Da nao tian gong",2014,0,167840000,167840000
955,"Dodgeball: A True Underdog Story",2004,114326736,53464968,167791704
956,"3 Men and a Baby",1987,167780960,0,167780960
957,"Alexander",2004,34297191,133000000,167297191
958,"Xi you ji zhi da sheng gui lai",2015,0,166968128,166968128
959,"Up in the Air",2009,83823381,83019358,166842739
960,"Seven Pounds",2008,69951824,96665504,166617328
961,"Nutty Professor II: The Klumps",2000,123307945,43000000,166307945
962,"Stuart Little 2",2002,64956806,101043194,166000000
963,"Contact",1997,100920329,64979671,165900000
964,"The Scorpion King",2002,90580000,75310634,165890634
965,"Step Up 3D",2010,42400223,123488894,165889117
966,"Unstoppable",2010,81562942,84157979,165720921
967,"Sleepers",1996,53300852,112300000,165600852
968,"Step Up Revolution",2012,35074677,130477613,165552290
969,"The Princess Diaries",2001,108244774,57090000,165334774
970,"Cold Mountain",2003,95632614,69541295,165173909
971,"The Huntsman: Winter’s War",2016,48003015,117146287,165149302
972,"In Time",2011,37553932,127550020,165103952
973,"Deep Blue Sea",1999,73648228,91400000,165048228
974,"Six Days, Seven Nights",1998,74339294,90460706,164800000
975,"Bringing Down the House",2003,132675402,32000000,164675402
976,"Johnny English Reborn",2011,8406711,156233690,164640401
977,"Daddy Day Care",2003,104148781,60136806,164285587
978,"No Country for Old Men",2007,74273505,89762248,164035753
979,"The Grand Budapest Hotel",2014,59076019,104905242,163981261
980,"Saw III",2006,80238724,83638091,163876815
981,"Maid in Manhattan",2002,93932896,69905321,163838217
982,"Miami Vice",2006,63478838,100339718,163818556
983,"Pokemon: The First Movie",1999,85744662,77900000,163644662
984,"Unbroken",2014,115637895,47889929,163527824
985,"World Trade Center",2006,70278893,93016761,163295654
986,"Johnny English",2003,28013509,135113167,163126676
987,"The Island",2005,35818913,127200000,163018913
988,"Talladega Nights: The Ballad of Ricky Bobby",2006,148213377,14657148,162870525
989,"The Spiderwick Chronicles",2008,71195053,91644614,162839667
990,"The Happening",2008,64506874,98271510,162778384
991,"The Interpreter",2005,72708161,90045676,162753837
992,"Dick Tracy",1990,103738726,59000000,162738726
993,"The Magnificent Seven",2016,93432655,69092501,162525156
994,"Midnight in Paris",2011,56816662,105686112,162502774
995,"Bridge of Spies",2015,72313754,90184584,162498338
996,"The Ring Two",2005,75941727,86000000,161941727
997,"Insidious Chapter 2",2013,83586447,78335068,161921515
998,"Scream 3",2000,89138076,72700000,161838076
999,"Live and Let Die",1973,35400000,126400000,161800000
1000,"Payback",1999,81526121,80100000,161626121
1001,"Memoirs of a Geisha",2005,57010853,104500000,161510853
1002,"The Muppets",2011,88625922,72346000,160971922
1003,"Jackass Presents: Bad Grandpa",2013,102003019,58900000,160903019
1004,"Freaky Friday",2003,110222438,50600000,160822438
1005,"Alien: Resurrection",1997,47795018,112904982,160700000
1006,"America's Sweethearts",2001,93607673,67040820,160648493
1007,"Flight",2012,93772375,66786063,160558438
1008,"Legends of the Fall",1994,66502573,94000000,160502573
1009,"Hellboy II: The Golden Army",2008,75986503,84401560,160388063
1010,"Underworld: Awakening",2012,62321039,98058891,160379930
1011,"27 Dresses",2008,76808654,83439151,160247805
1012,"Three Billboards Outside Ebbing, Missouri",2017,54513740,105678175,160191915
1013,"Never Say Never Again",1983,55500000,104500000,160000000
1014,"Jack Reacher: Never Go Back",2016,58697076,101249413,159946489
1015,"21",2008,81159365,78687064,159846429
1016,"Stepmom",1998,91137662,68607617,159745279
1017,"Black Hawk Down",2001,108638745,51052340,159691085
1018,"The Sting",1973,159616327,0,159616327
1019,"The Predator",2018,51024708,108462855,159487563
1020,"Johnny English Strikes Again",2018,4412170,154990993,159403163
1021,"Crimson Tide",1995,91387195,68000000,159387195
1022,"The Jackal",1997,54956941,104400000,159356941
1023,"Unforgiven",1992,101157447,58000000,159157447
1024,"Demolition Man",1993,58055768,101000000,159055768
1025,"Don’t Breathe",2016,89217875,69755810,158973685
1026,"Norbit",2007,95673607,63300000,158973607
1027,"The Pink Panther",2006,82226474,76700000,158926474
1028,"Daylight",1996,32908290,126000000,158908290
1029,"Goosebumps",2015,80069458,78835866,158905324
1030,"The Book of Eli",2010,94835059,63915758,158750817
1031,"The Monuments Men",2014,78031620,80671128,158702748
1032,"Sin City",2005,74103820,84424098,158527918
1033,"Alien 3",1992,54927174,103572826,158500000
1034,"Happy Feet Two",2011,64006466,93950000,157956466
1035,"The Fast and the Furious: Tokyo Drift",2006,62615510,95178695,157794205
1036,"Days of Thunder",1990,82670733,75000000,157670733
1037,"Yip Man 3",2015,2679437,154621517,157300954
1038,"Lara Croft: Tomb Raider: The Cradle of Life",2003,65653758,91439185,157092943
1039,"This Means War",2012,54760791,102213766,156974557
1040,"Mystic River",2003,90135191,66686829,156822020
1041,"War Horse",2011,79883359,76932170,156815529
1042,"Under Siege",1992,83563139,73000000,156563139
1043,"Dumb and Dumber To",2014,86208010,70345582,156553592
1044,"Planes: Fire and Rescue",2014,59157732,97241912,156399644
1045,"Rocky Balboa",2006,70269899,85959151,156229050
1046,"Licence to Kill",1989,34667015,121500000,156167015
1047,"Monster-in-Law",2005,82931301,73000000,155931301
1048,"P.S. I Love You",2007,53695808,102073870,155769678
1049,"The Haunted Mansion",2003,75817994,79932634,155750628
1050,"Dreamgirls",2006,103365956,52342739,155708695
1051,"Limitless",2011,79249455,76315464,155564919
1052,"Scary Movie 3",2003,110000082,45199918,155200000
1053,"Cool Runnings",1993,68856263,86200000,155056263
1054,"Final Destination 5",2011,42587643,112423522,155011165
1055,"Blade 2",2002,81676888,72661713,154338601
1056,"Beverly Hills Chihuahua",2008,94514402,59703766,154218168
1057,"Escape Room",2019,56958215,97029814,153988029
1058,"The Phantom of the Opera",2004,51225796,102544256,153770052
1059,"Ride Along",2014,134202565,19531235,153733800
1060,"Free Willy",1993,77698625,76000000,153698625
1061,"Kill Bill: Volume 2",2004,66207920,87328062,153535982
1062,"Bi Bei Shang Geng Bei Shang De Gu Shi",2018,722669,152630000,153352669
1063,"Sweeney Todd: The Demon Barber of Fleet Street",2007,52898073,100431771,153329844
1064,"101 Dalmatians",1961,153000000,301581,153301581
1065,"Cheng feng po lang",2017,469706,152549032,153018738
1066,"Devil's Advocate",1997,61007424,92000000,153007424
1067,"The Accountant",2016,86260045,66702038,152962083
1068,"Saw II",2005,87025093,65900000,152925093
1069,"Another 48 Hrs.",1990,80047413,72700000,152747413
1070,"A View to a Kill",1985,50327960,102300000,152627960
1071,"The Town",2010,92186262,60380619,152566881
1072,"Chocolat",2000,71309760,81190583,152500343
1073,"Antz",1998,90757863,61700000,152457863
1074,"Backdraft",1991,77868585,74500000,152368585
1075,"The Taking of Pelham 123",2009,65452312,86912058,152364370
1076,"Date Night",2010,98711404,53557629,152269033
1077,"A Time to Kill",1996,108766007,43500000,152266007
1078,"Phenomenon",1996,104636382,47400000,152036382
1079,"Congo",1995,81022333,71000000,152022333
1080,"Evita",1996,50047179,101900000,151947179
1081,"47 Ronin",2013,38362475,113354340,151716815
1082,"Big",1988,114968774,36700000,151668774
1083,"Pan",2015,35088320,116437653,151525973
1084,"Kari gurashi no Arietti",2012,19192510,132303587,151496097
1085,"The Bone Collector",1999,66488090,84975000,151463090
1086,"Vantage Point",2008,72266306,78620023,150886329
1087,"Darkest Hour",2017,56443120,94364052,150807172
1088,"Olympus Has Fallen",2013,98927592,51634572,150562164
1089,"Jack and Jill",2011,74158157,76361060,150519217
1090,"Speed 2: Cruise Control",1997,48097081,102370919,150468000
1091,"Into the Storm",2014,47602194,102827177,150429371
1092,"Tower Heist",2011,78046570,72376376,150422946
1093,"Mononoke-hime",1999,2374107,147975893,150350000
1094,"Star Trek: First Contact",1996,92027888,57972112,150000000
1095,"Resident Evil: Extinction",2007,50648679,99222424,149871103
1096,"Lone Survivor",2013,125095601,24709031,149804632
1097,"Arthur Christmas",2011,46462469,103254655,149717124
1098,"The General's Daughter",1999,102705852,47000000,149705852
1099,"Lion",2016,51739495,97831225,149570720
1100,"Me, Myself & Irene",2000,90570999,58700000,149270999
1101,"No Strings Attached",2011,70662220,78565858,149228078
1102,"Ghost Rider: Spirit of Vengeance",2012,51774002,97443353,149217355
1103,"Death Becomes Her",1992,58422650,90600000,149022650
1104,"Lights Out",2016,67268835,81537675,148806510
1105,"Seabiscuit",2003,120277854,28437488,148715342
1106,"Step Up 2 the Streets",2008,58017783,90569127,148586910
1107,"Broken Arrow",1996,70645997,77700000,148345997
1108,"Gremlins",1984,148168459,31056,148199515
1109,"Mama",2013,71628180,76467386,148095566
1110,"Garfield: A Tail of Two Kitties",2006,28426747,119558626,147985373
1111,"The Hateful Eight",2015,54117416,93747470,147864886
1112,"Romeo+Juliet",1996,46338728,101203653,147542381
1113,"Crazy, Stupid, Love",2011,84351197,62791131,147142328
1114,"Swordfish",2001,69772969,77307444,147080413
1115,"Stand By Me Doraemon",2014,0,147000000,147000000
1116,"New Year’s Eve",2011,54544638,92305635,146850273
1117,"Friends with Benefits",2011,55802754,90793137,146595891
1118,"The Game Plan",2007,90648202,55942785,146590987
1119,"Gun dan ba! Zhong liu jun",2015,286639,146200000,146486639
1120,"Du Cheng Feng Yun 2",2015,0,146203224,146203224
1121,"Music and Lyrics",2007,50572589,95624296,146196885
1122,"I am Number Four",2011,55100437,91094722,146195159
1123,"Time Raiders",2016,0,145974597,145974597
1124,"Red Sparrow",2018,46874505,99077356,145951861
1125,"Blades of Glory",2007,118594548,27000000,145594548
1126,"Surf's Up",2007,58867694,86528051,145395745
1127,"The Mexican",2001,66808615,78429635,145238250
1128,"The Exorcism of Emily Rose",2005,75072454,69456624,144529078
1129,"Herbie: Fully Loaded",2005,66010682,78100000,144110682
1130,"Charlotte's Web",2006,82985708,61000000,143985708
1131,"Spy Game",2001,62362560,80687000,143049560
1132,"Paranormal Activity 4",2012,53900335,88917657,142817992
1133,"Conspiracy Theory",1997,76118990,66664728,142783718
1134,"The Wolfman",2010,62189884,80444474,142634358
1135,"Power Rangers",2017,85364450,57167102,142531552
1136,"SpongeBob SquarePants: The Movie",2004,85416609,56634646,142051255
1137,"Dear John",2010,80014842,62018667,142033509
1138,"The Jungle Book",1967,141843000,0,141843000
1139,"Legally Blonde",2001,96493426,45315809,141809235
1140,"National Lampoon's Animal House",1978,141600000,0,141600000
1141,"RED 2",2013,53262560,88244795,141507355
1142,"Gothika",2003,59588068,81896744,141484812
1143,"The Legend of Zorro",2005,45575336,95900000,141475336
1144,"Sausage Party",2016,97670358,43673897,141344255
1145,"Monster House",2006,73661010,67606360,141267370
1146,"Bad Boys",1995,65647413,75600000,141247413
1147,"Mona Lisa Smile",2003,63803100,77402069,141205169
1148,"Thunderball",1965,63600000,77600000,141200000
1149,"Scary Movie 2",2001,71277420,69911681,141189101
1150,"Trainwreck",2015,110212700,30911197,141123897
1151,"The Devil's Own",1997,42885593,98014407,140900000
1152,"The Rugrats Movie",1998,100494685,40400000,140894685
1153,"Girls Trip",2017,115108515,25777838,140886353
1154,"The Foreigner",2017,34393507,106389853,140783360
1155,"Source Code",2011,54712227,85716272,140428499
1156,"The Jungle Book 2",2003,47901582,92220643,140122225
1157,"Sommersby",1993,50081992,90000000,140081992
1158,"American Graffiti",1973,115000000,25000000,140000000
1159,"The Three Musketeers",2011,20377913,119500000,139877913
1160,"Annie",2014,85911262,53918363,139829625
1161,"Anastasia",1997,58403409,81397687,139801096
1162,"Legend of the Guardians: The Owls of Ga'Hoole",2010,55675313,84041404,139716717
1163,"Towering Inferno",1974,116000000,23700000,139700000
1164,"King Arthur: Legend of the Sword",2017,39175066,100455270,139630336
1165,"17 Again",2009,64167069,75307837,139474906
1166,"Lao pao er",2015,1414696,137789916,139204612
1167,"Die Hard",1988,81350242,57759104,139109346
1168,"Star Trek: The Motion Picture",1979,82258456,56741544,139000000
1169,"Gods of Egypt",2016,31153464,107683292,138836756
1170,"Brüno",2009,60054530,78653997,138708527
1171,"Bird on a Wire",1990,70978012,67719000,138697012
1172,"Nine Months",1995,69660733,68825698,138486431
1173,"Bridge to Terabithia",2007,82234139,55750649,137984788
1174,"Platoon",1986,137963328,15067,137978395
1175,"Pete’s Dragon",2016,76233151,61535824,137768975
1176,"Contagion",2011,75658097,61893497,137551594
1177,"Abraham Lincoln: Vampire Hunter",2012,37519139,99970591,137489730
1178,"Wall Street 2: Money Never Sleeps",2010,52474616,84957003,137431619
1179,"Last Action Hero",1993,50016394,87282095,137298489
1180,"Big Momma's House 2",2006,70165972,66881404,137047376
1181,"Stardust",2007,38634938,98387307,137022245
1182,"Anaconda",1997,65598907,71400000,136998907
1183,"Let’s Be Cops",2014,82390774,54500000,136890774
1184,"How Long Will I Love U",2018,746933,136000929,136747862
1185,"Remember the Titans",2000,115654751,21051932,136706683
1186,"The First Purge",2018,69488745,67128560,136617305
1187,"Love Story",1970,106397186,30000000,136397186
1188,"The Pirates! Band of Misfits",2012,31051126,105092479,136143605
1189,"Unknown",2011,63686397,72436686,136123083
1190,"Lost In Space",1998,69117629,66929688,136047317
1191,"The Bounty Hunter",2010,67061228,68747609,135808837
1192,"Saw IV",2007,63300095,72459599,135759694
1193,"American Made",2017,51342000,84227212,135569212
1194,"Cheaper by the Dozen 2",2005,82571173,52444157,135015330
1195,"Sense and Sensibility",1995,42993774,92000000,134993774
1196,"The Best Exotic Marigold Hotel",2012,46383639,88256141,134639780
1197,"Zero Dark Thirty",2012,95720716,38891719,134612435
1198,"Pokemon 2000",2000,43746923,90200000,133946923
1199,"The Cat in the Hat",2003,101018283,32800000,133818283
1200,"Saw 3D",2010,45710178,88025106,133735284
1201,"Perfume: The Story of a Murderer",2006,2223293,131380170,133603463
1202,"Myeong-ryang",2014,2830989,130619928,133450917
1203,"Hot Shots! Part Deux",1993,38618836,94829853,133448689
1204,"A Wrinkle in Time",2018,100478608,32923274,133401882
1205,"La marche de l'empereur",2005,77437223,55839136,133276359
1206,"The Big Short",2015,70259870,62902882,133162752
1207,"Hope Springs",2012,63536011,69549284,133085295
1208,"Star Trek IV: The Voyage Home",1986,109713132,23286868,133000000
1209,"Astérix aux Jeux Olympiques",2008,999811,132000000,132999811
1210,"2 Guns",2013,75612460,56880555,132493015
1211,"A League of Their Own",1992,107533925,24906141,132440066
1212,"Babel",2006,34302837,97818375,132121212
1213,"School of Rock",2003,81261177,50683495,131944672
1214,"Munich",2005,47379090,84113682,131492772
1215,"Seven Years in Tibet",1997,37945884,93500000,131445884
1216,"Jack Ryan: Shadow Recruit",2014,50577412,80800000,131377412
1217,"Blade: Trinity",2004,52397389,78955776,131353165
1218,"1408",2007,71985628,59277742,131263370
1219,"Blade",1998,70141876,61095812,131237688
1220,"Skiptrace",2016,1792,131200745,131202537
1221,"Law Abiding Citizen",2009,73357727,57802054,131159781
1222,"Bewitched",2005,63313159,67846147,131159306
1223,"Boomerang",1992,70052444,61000000,131052444
1224,"Wolf",1994,65011757,66000000,131011757
1225,"Man on Fire",2004,77906816,53061763,130968579
1226,"Mean Girls",2004,86047227,44905799,130953026
1227,"The Last Witch Hunter",2015,27367660,103451252,130818912
1228,"About a Boy",2002,40803000,89956651,130759651
1229,"Cloud Atlas",2012,27108272,103564882,130673154
1230,"You, Me and Dupree",2006,75802010,54600000,130402010
1231,"V for Vendetta",2006,70511035,59703127,130214162
1232,"Jingle All the Way",1996,60592389,69240000,129832389
1233,"An Officer and a Gentleman",1982,129795554,0,129795554
1234,"Atonement",2007,50980159,78799569,129779728
1235,"The Fighter",2010,93617009,35645379,129262388
1236,"The Forbidden Kingdom",2008,52075270,77000000,129075270
1237,"The Woman in Black",2012,54333290,74622608,128955898
1238,"The Queen",2006,56441711,72444162,128885873
1239,"Aliens vs. Predator - Requiem",2007,41797066,87087428,128884494
1240,"Space Cowboys",2000,90454043,38420000,128874043
1241,"The Talented Mr. Ripley",1999,81292135,47500000,128792135
1242,"Nanny McPhee",2006,47279279,81466299,128745578
1243,"Secret Superstar",2017,0,128649838,128649838
1244,"Step Brothers",2008,100468793,28000000,128468793
1245,"Failure to Launch",2006,88715192,39687709,128402901
1246,"The Artist",2011,44667095,83589617,128256712
1247,"Blended",2014,46290741,81700000,127990741
1248,"Everest",1998,87178599,40811529,127990128
1249,"Ender's Game",2013,61737191,66246092,127983283
1250,"Forever Young",1992,55942530,72000000,127942530
1251,"The Heartbreak Kid",2007,36787257,90981533,127768790
1252,"Gandhi",1982,52767889,75000000,127767889
1253,"A Bad Moms Christmas",2017,72110659,55599891,127710550
1254,"U-571",2000,77086030,50544000,127630030
1255,"First Knight",1995,37361412,90000000,127361412
1256,"Predators",2010,52000688,75233701,127234389
1257,"The Adjustment Bureau",2011,62495645,64435680,126931325
1258,"Smokey and the Bandit",1977,126737428,0,126737428
1259,"Point Break",2015,28782481,97922110,126704591
1260,"Julie & Julia",2009,94125426,32520693,126646119
1261,"Captain Underpants: The First Epic Movie",2017,73921000,52656874,126577874
1262,"Pride & Prejudice",2005,38372662,88176945,126549607
1263,"This is the End",2013,101470202,25068915,126539117
1264,"Space Station",2002,93231060,33282126,126513186
1265,"American Wedding",2003,104354205,22070910,126425115
1266,"The House with a Clock in its Walls",2018,68549695,57782055,126331750
1267,"Parenthood",1989,100047830,26250000,126297830
1268,"L.A. Confidential",1997,64604977,61600000,126204977
1269,"Sex Tape",2014,38543473,87526036,126069509
1270,"Staying Alive",1983,63841474,62200000,126041474
1271,"Coraline",2009,75286229,50750828,126037057
1272,"The Dream is Alive",1985,125900000,0,125900000
1273,"Legally Blonde 2: Red, White & Blonde",2003,90639088,34700000,125339088
1274,"I Know What You Did Last Summer",1997,72250091,53000000,125250091
1275,"First Blood",1982,47212904,78000000,125212904
1276,"Resident Evil: Apocalypse",2004,50740078,74428656,125168734
1277,"Rocky III",1982,125049125,0,125049125
1278,"Happy Death Day",2017,55683845,69326415,125010260
1279,"Fack ju Gohte 2",2015,0,125000000,125000000
1280,"Goldfinger",1964,51100000,73800000,124900000
1281,"Ride Along 2",2016,90862685,33964631,124827316
1282,"Ray",2004,75305995,49517099,124823094
1283,"The Family Man",2000,75764085,48951778,124715863
1284,"Geukhanjikeob",2019,1565885,123030293,124596178
1285,"Invictus",2009,37491364,87022647,124514011
1286,"The Thomas Crown Affair",1999,69304264,55000000,124304264
1287,"City Slickers",1991,124033791,0,124033791
1288,"Big Fish",2003,66432867,57521456,123954323
1289,"Good Morning Vietnam",1987,123922370,0,123922370
1290,"Hide and Seek",2005,51100486,72596255,123696741
1291,"Chronicle",2012,64575175,59106615,123681790
1292,"Magic Mike XXL",2015,66013057,57647540,123660597
1293,"Walking with Dinosaurs",2013,36076121,87292721,123368842
1294,"The Wedding Singer",1998,80245725,43100000,123345725
1295,"The Theory of Everything",2014,35893537,87434155,123327692
1296,"The Lego Ninjago Movie",2017,59281555,63455646,122737201
1297,"Deepwater Horizon",2016,61433527,61170297,122603824
1298,"The Nut Job",2014,64251538,58278428,122529966
1299,"Tian jiang xiong shi",2015,74070,122445804,122519874
1300,"Hotel for Dogs",2009,73178547,49178625,122357172
1301,"Save the Last Dance",2001,91038276,31206053,122244329
1302,"Mortal Kombat",1995,70433227,51700000,122133227
1303,"Executive Decision",1996,56679192,65400000,122079192
1304,"The Princess Diaries 2: Royal Engagement",2004,95149435,26922000,122071435
1305,"Bajrangi Bhaijaan",2015,8178001,113600346,121778347
1306,"Poltergeist",1982,74706019,47000000,121706019
1307,"Sahara",2005,68671925,53000000,121671925
1308,"Intolerable Cruelty",2003,35327628,86000000,121327628
1309,"Starship Troopers",1997,54768952,66331048,121100000
1310,"Apocalypto",2006,50866635,70165637,121032272
1311,"Parental Guidance",2012,77267296,43565087,120832383
1312,"To Fly!",1976,86600000,34100000,120700000
1313,"Tang ren jie tan an",2015,459832,120183719,120643551
1314,"Eight Below",2006,81612565,38843429,120455994
1315,"Insidious Chapter 3",2015,52218558,68234597,120453155
1316,"Lethal Weapon",1987,65192350,55000000,120192350
1317,"Volcano",1997,47546796,72553204,120100000
1318,"Star Trek: Generations",1994,75671262,44328738,120000000
1319,"Qu'est ce qu'on a fait au bon dieu",2014,0,120000000,120000000
1320,"Rocky V",1990,40946358,79000000,119946358
1321,"Jeepers Creepers II",2003,35623801,84300000,119923801
1322,"Michael",1996,95345070,24400000,119745070
1323,"Road Trip",2000,68525609,51213501,119739110
1324,"Instant Family",2018,67363237,52372951,119736188
1325,"Spy Kids 2: The Island of Lost Dreams",2002,85846296,33875000,119721296
1326,"Surrogates",2009,38577772,81090578,119668350
1327,"Red Cliff",2009,627047,119000000,119627047
1328,"Charlie Wilson's War",2007,66661095,52851676,119512771
1329,"Blazing Saddles",1974,119500000,0,119500000
1330,"I Belonged to You",2016,743507,118675362,119418869
1331,"The Omen",2006,54607383,64688201,119295584
1332,"On Golden Pond",1981,119285432,0,119285432
1333,"Allied",2016,40098064,79168597,119266661
1334,"Beverly Hills Cop III",1994,42586861,76594077,119180938
1335,"Unfaithful",2002,52752475,66362019,119114494
1336,"Wu Wen Xi Dong",2018,0,119035160,119035160
1337,"The Upside",2019,108079314,10789039,118868353
1338,"The Shallows",2016,55121623,63641819,118763442
1339,"We Bought a Zoo",2011,75624550,43104523,118729073
1340,"Barnyard: The Original Party Animals",2006,72779000,45804844,118583844
1341,"Body of Lies",2008,39394666,79161864,118556530
1342,"Disturbia",2007,80818974,37718653,118537627
1343,"Hua Pi 2",2012,33212,118495630,118528842
1344,"The Purge: Election Year",2016,79042440,39472287,118514727
1345,"Saw V",2008,56746769,61463009,118209778
1346,"Huang Qiang Zou Ban",2018,551196,117577445,118128641
1347,"Shall We Dance?",2004,57887882,60210000,118097882
1348,"Kaze Tachinu",2013,5201879,112722821,117924700
1349,"Star Trek: Insurrection",1998,70187658,47612342,117800000
1350,"A Nightmare on Elm Street",2010,63075011,54654610,117729621
1351,"The Client",1994,92115211,25500000,117615211
1352,"Blue Streak",1999,68208190,49239967,117448157
1353,"Why Him?",2016,60323786,57101370,117425156
1354,"Game Night",2018,69179066,48199018,117378084
1355,"Dennis the Menace",1993,51270765,66000000,117270765
1356,"The Forgotten",2004,66711892,50500000,117211892
1357,"Lang Tu Teng",2015,212616,116888636,117101252
1358,"Lost in Translation",2003,44585453,72499844,117085297
1359,"Snow Dogs",2002,81150692,35747336,116898028
1360,"Water for Elephants",2011,58709717,58100000,116809717
1361,"Earth",2009,32011576,84761741,116773317
1362,"The Siege",1998,40934175,75691623,116625798
1363,"Sliver",1993,36280867,80000000,116280867
1364,"Closer",2004,33987757,82189938,116177695
1365,"Dragon Ball Super: Broly",2018,30376755,85758306,116135061
1366,"Finding Mr Right 2",2016,0,116100802,116100802
1367,"Pitch Perfect",2012,65001093,51043254,116044347
1368,"The Notebook",2004,81001787,35023236,116025023
1369,"Diamonds Are Forever",1971,43800000,72200000,116000000
1370,"Da Huo Zhong",2016,0,116000000,116000000
1371,"Si Ren Ding Zhi",2013,369225,115520000,115889225
1372,"The Iron Lady",2012,29959436,85632668,115592104
1373,"Bride Wars",2009,58715510,56434914,115150424
1374,"Warm Bodies",2013,66380662,48740946,115121608
1375,"The Karate Kid, Part II",1986,115103979,0,115103979
1376,"Xi You Ji Nu Er Guo",2018,187074,114902870,115089944
1377,"Romancing the Stone",1984,75078260,40000000,115078260
1378,"Finding Neverland",2004,51676606,63359502,115036108
1379,"Get Shorty",1995,72021008,43000000,115021008
1380,"Saving Mr. Banks",2013,83299761,31662764,114962525
1381,"The Lake House",2006,52330111,62500000,114830111
1382,"Corpse Bride",2005,53359111,61411543,114770654
1383,"We Were Soldiers",2002,78120196,36538066,114658262
1384,"Freddy vs. Jason",2003,82622655,31953748,114576403
1385,"Coyote Ugly",2000,60786269,53130205,113916474
1386,"Changeling",2008,35739802,78065778,113805580
1387,"Insomnia",2002,67263182,46359317,113622499
1388,"The Score",2001,71069884,42472207,113542091
1389,"Judge Dredd",1995,34687912,78800000,113487912
1390,"The Dark Tower",2017,50701325,62760202,113461527
1391,"Underworld: Evolution",2006,62318875,51098887,113417762
1392,"Prisoners",2013,61002302,52400000,113402302
1393,"Think Like a Man",2012,91547205,21826559,113373764
1394,"Species",1995,60054449,53300000,113354449
1395,"Arthur et les Minimoys",2007,15132763,98192980,113325743
1396,"Striptease",1996,33109743,80200000,113309743
1397,"Cats & Dogs: The Revenge of Kitty Galore",2010,43585753,69440630,113026383
1398,"The Reader",2008,34194407,78770468,112964875
1399,"Last Vegas",2013,63914167,49000000,112914167
1400,"Final Destination 3",2006,54098051,58700000,112798051
1401,"Tooth Fairy",2010,60022256,52588130,112610386
1402,"Where Are We Going Dad?",2014,0,112370000,112370000
1403,"Rambo",2008,42754105,69460426,112214531
1404,"Final Destination",2000,53302314,58734556,112036870
1405,"Doctor Zhivago",1965,111897830,138493,112036323
1406,"Frankenstein",1994,22006296,90000000,112006296
1407,"The Boxtrolls",2014,50837305,61108946,111946251
1408,"The Pianist",2002,32519322,79334860,111854182
1409,"You Only Live Twice",1967,43100000,68500000,111600000
1410,"The Purge: Anarchy",2014,71562550,39972331,111534881
1411,"White Chicks",2004,69148997,42300000,111448997
1412,"The 5th Wave",2016,34912982,76423416,111336398
1413,"Moneyball",2011,75605492,35695343,111300835
1414,"Step Up",2006,65328121,45661036,110989157
1415,"The Net",1995,50621733,59900000,110521733
1416,"Casino",1995,42438300,67961700,110400000
1417,"Free Birds",2013,55750480,54636592,110387072
1418,"Buddies in India",2017,292662,109911139,110203801
1419,"Peter Pan: Return to Neverland",2002,48430258,61432424,109862682
1420,"The Dukes of Hazzard",2005,80270227,29578234,109848461
1421,"Hoodwinked",2006,51386611,58456779,109843390
1422,"Sideways",2004,71502303,38290889,109793192
1423,"Mechanic: Resurrection",2016,21218403,88520437,109738840
1424,"Porky's",1982,109492484,0,109492484
1425,"Män som hatar kvinnor",2009,12749992,96671919,109421911
1426,"Fool's Gold",2008,70231041,39131925,109362966
1427,"Billy Elliot",2000,21995263,87258482,109253745
1428,"The Amityville Horror",2005,65233369,43942304,109175673
1429,"One Flew Over the Cuckoo's Nest",1975,108981275,16354,108997629
1430,"Planet 51",2009,42194060,66802053,108996113
1431,"Seventh Son",2014,17725785,91149182,108874967
1432,"Neighbors 2: Sorority Rising",2016,55340730,53416891,108757621
1433,"Pompeii",2014,23169033,85300000,108469033
1434,"Junior",1994,36763355,71668000,108431355
1435,"Terms of Endearment",1983,108423489,0,108423489
1436,"10 Cloverfield Lane",2016,72082999,36203423,108286422
1437,"Superman II",1981,108185706,0,108185706
1438,"ParaNorman",2012,56003051,52116611,108119662
1439,"Meitantei Conan: Zero no Shikkônin",2018,0,108105223,108105223
1440,"Hidalgo",2004,67286731,40800000,108086731
1441,"Confessions of a Shopaholic",2009,44277350,63750351,108027701
1442,"The Texas Chainsaw Massacre",2003,80571655,27395664,107967319
1443,"The American President",1995,60022813,47800000,107822813
1444,"Three Kings",1999,60652036,47100000,107752036
1445,"Paul Blart: Mall Cop 2",2015,71091594,36559052,107650646
1446,"The Santa Clause 3: The Escape Clause",2006,84500122,23000000,107500122
1447,"Transporter 3",2008,31715062,75520530,107235592
1448,"Ace Ventura: Pet Detective",1994,72217396,35000000,107217396
1449,"The Chronicles of Riddick",2004,57712751,49500000,107212751
1450,"Shaft",2000,70327868,36862240,107190108
1451,"About Schmidt",2002,65005217,42049267,107054484
1452,"The Breakup Guru",2014,208959,106590000,106798959
1453,"Driving Miss Daisy",1989,106593296,0,106593296
1454,"Made of Honor",2008,46012734,60536004,106548738
1455,"Spirit: Stallion of the Cimarron",2002,73215310,33300000,106515310
1456,"Get Hard",2015,90411453,16100000,106511453
1457,"Boonie Bears:Blast Into The Past",2019,0,106344552,106344552
1458,"Mr. Holland’s Opus",1995,82582604,23700000,106282604
1459,"Kramer vs. Kramer",1979,106260000,0,106260000
1460,"Sisters",2015,87044645,18986015,106030660
1461,"Mission to Mars",2000,60874615,45125385,106000000
1462,"Horrible Bosses 2",2014,54445357,51500000,105945357
1463,"Life as We Know It",2010,53374681,52513156,105887837
1464,"The Brothers Grimm",2005,37899638,67400000,105299638
1465,"Hereafter",2010,32746941,72500000,105246941
1466,"First Man",2018,44936545,60267280,105203825
1467,"Forgetting Sarah Marshall",2008,63172463,42000579,105173042
1468,"Along Came a Spider",2001,74058698,31100387,105159085
1469,"Race to Witch Mountain",2009,67172595,37931189,105103784
1470,"Dirty Grandpa",2016,35593113,69485336,105078449
1471,"Cinderella Man",2005,61649911,43371577,105021488
1472,"Chappie",2015,31569268,73432788,105002056
1473,"The Man From U.N.C.L.E.",2015,45445109,59504475,104949584
1474,"Made In America",1993,44942695,60000000,104942695
1475,"The Campaign",2012,86907746,18000000,104907746
1476,"Cold War 2",2016,560824,103968662,104529486
1477,"Training Day",2001,76261036,28244326,104505362
1478,"Vicky Cristina Barcelona",2008,23216709,81288108,104504817
1479,"Don’t Say a Word",2001,54997476,49490907,104488383
1480,"The Graduate",1967,104397102,36841,104433943
1481,"The Tuxedo",2002,50586000,53843625,104429625
1482,"The Prestige",2006,53089891,51317475,104407366
1483,"Dragonheart",1996,51364680,53000000,104364680
1484,"Under Siege 2: Dark Territory",1995,50024083,54300000,104324083
1485,"Sanctum",2011,23209310,81074443,104283753
1486,"Every Which Way but Loose",1978,104268727,0,104268727
1487,"Eyes Wide Shut",1999,55691208,48576235,104267443
1488,"Along With The Gods: The Two Worlds",2017,1908822,102224796,104133618
1489,"Gangster Squad",2013,46000903,58100000,104100903
1490,"Snake Eyes",1998,55591409,48300000,103891409
1491,"Saw",2004,55968727,47911300,103880027
1492,"Resident Evil",2002,40119709,63667692,103787401
1493,"Escape Plan",2013,25135965,78600000,103735965
1494,"Wukong",2017,0,103651195,103651195
1495,"Dawn of the Dead",2004,58990765,44462110,103452875
1496,"The Water Horse: Legend of the Deep",2007,40412817,63016938,103429755
1497,"Ouija",2014,50856010,52444622,103300632
1498,"Nine to Five",1980,103290500,9647,103300147
1499,"Rugrats in Paris",2000,76501438,26783375,103284813
1500,"Birdman or (The Unexpected Virtue of Ignorance)",2014,42340598,60874496,103215094
1501,"T-Rex: Back to the Cretaceous",1998,53743249,49300000,103043249
1502,"Transcendence",2014,23022309,80016949,103039258
1503,"Project X",2012,54731865,48296323,103028188
1504,"Night School",2018,77339130,25669662,103008792
1505,"Jimmy Neutron: Boy Genius",2001,80936232,22056304,102992536
1506,"Blue Jasmine",2013,33404871,69508090,102912961
1507,"My Bloody Valentine",2009,51545952,51290050,102836002
1508,"The Cable Guy",1996,60240295,42585501,102825796
1509,"The Hitchhiker's Guide to the Galaxy",2005,51019112,51727102,102746214
1510,"Love and Other Drugs",2010,32367005,70349316,102716321
1511,"Primal Fear",1996,56073633,46500000,102573633
1512,"Ghosts of Girlfriends Past",2009,55250026,47262776,102512802
1513,"Jigsaw",2017,38052832,64392364,102445196
1514,"Pineapple Express",2008,87341380,15062639,102404019
1515,"Ladder 49",2004,74541707,27791141,102332848
1516,"The Time Traveler's Wife",2009,63414846,38917289,102332135
1517,"Butch Cassidy and the Sundance Kid",1969,102308900,1753,102310653
1518,"Vacation",2015,58884188,43422312,102306500
1519,"Mary Poppins",1964,102272145,0,102272145
1520,"Zombieland",2009,75590286,26646310,102236596
1521,"John Q",2002,71026631,31200000,102226631
1522,"Guess Who",2005,68915888,33200000,102115888
1523,"Timecop",1994,44853581,57200000,102053581
1524,"Kung Fu Hustle",2004,17104669,84929435,102034104
1525,"The Little Prince",2015,1311213,100717706,102028919
1526,"The Commuter",2018,36343858,65641573,101985431
1527,"Fan Tang Feng Bao 4",2019,0,101949793,101949793
1528,"Shaun the Sheep",2015,19375982,82549179,101925161
1529,"Nim's Island",2008,48006762,53850663,101857425
1530,"Railroad Tigers",2016,218044,101595233,101813277
1531,"The Devil Inside",2012,53262945,48496545,101759490
1532,"Little Man",2006,58636047,43000000,101636047
1533,"Just Married",2003,56127162,45437773,101564935
1534,"Miss Congeniality 2: Armed and Fabulous",2005,48478006,52904390,101382396
1535,"Alexander and the Terrible, Horrible, No Good, …",2014,66954149,34425138,101379287
1536,"Mars Attacks!",1996,37771017,63600000,101371017
1537,"Stir Crazy",1980,101300000,0,101300000
1538,"The Recruit",2003,52784696,48389744,101174440
1539,"Crash",2005,55334418,45838620,101173038
1540,"Paul",2011,37412945,63749161,101162106
1541,"Joy",2015,56451232,44682827,101134059
1542,"Life",2017,30234022,70695644,100929666
1543,"Heaven is for Real",2014,91386097,9530202,100916299
1544,"Fight Club",1999,37030102,63821603,100851705
1545,"Courage Under Fire",1996,59003384,41829761,100833145
1546,"Just Like Heaven",2005,48318130,52368953,100687083
1547,"Up Close & Personal",1996,51045801,49600000,100645801
1548,"Little Miss Sunshine",2006,59891098,40751255,100642353
1549,"A Knight’s Tale",2001,56083966,44538620,100622586
1550,"Airport",1970,100489150,0,100489150
1551,"No se Aceptan Devoluciones",2013,44467206,56019410,100486616
1552,"Any Given Sunday",1999,75530832,24700000,100230832
1553,"Hou hui wu qi",2014,0,100110000,100110000
1554,"Zhi wo men zhong jiang shi qu de qing chun",2013,0,100030000,100030000
1555,"How to be Single",2016,46843513,53160267,100003780
1556,"The Good Shepherd",2006,59908565,40000000,99908565
1557,"Insidious",2011,54009150,45861736,99870886
1558,"Hellboy",2004,59623958,40200000,99823958
1559,"Mad Max",1980,8750000,91000000,99750000
1560,"Gukjesijang",2014,2305912,97378925,99684837
1561,"Alpha",2018,35851379,63773494,99624873
1562,"Street Fighter",1994,33423000,66000000,99423000
1563,"Nacho Libre",2006,80197993,19098469,99296462
1564,"Hitman",2007,39687694,59447877,99135571
1565,"Where the Wild Things Are",2009,77233467,21890189,99123656
1566,"Jiu ceng yao ta",2015,0,99120000,99120000
1567,"Justin Bieber: Never Say Never",2011,73013910,26020215,99034125
1568,"The Wild",2006,37384046,61626621,99010667
1569,"The Time Machine",2002,56684819,42298771,98983590
1570,"Philomena",2013,37709979,61253413,98963392
1571,"Black Mass",2015,62575678,36262194,98837872
1572,"Paycheck",2003,53789313,45030476,98819789
1573,"Heaven Can Wait",1978,98800000,0,98800000
1574,"Les Visiteurs",1996,659000,98095000,98754000
1575,"Bowfinger",1999,66458769,32241000,98699769
1576,"The Visit",2015,65206105,33471711,98677816
1577,"E gun tian shi",2015,131058,98501134,98632192
1578,"Busanhaeng",2016,2129768,96328335,98458103
1579,"Contraband",2012,66528000,31878855,98406855
1580,"French Kiss",1995,38863798,59530132,98393930
1581,"Atomic Blonde",2017,51573925,46771498,98345423
1582,"Evolution",2001,38311134,60030798,98341932
1583,"Predator",1987,59735548,38532010,98267558
1584,"Rush",2013,26947624,71283215,98230839
1585,"Jin líng shí san chai",2012,311434,97915583,98227017
1586,"Are We There Yet?",2005,82674398,15440073,98114471
1587,"Billy Jack",1971,98000000,0,98000000
1588,"Fred Claus",2007,72006777,25830861,97837638
1589,"Phone Booth",2003,46566212,51270926,97837138
1590,"Nanny McPhee and the Big Bang",2010,29197642,68602223,97799865
1591,"Evil Dead",2013,54239856,43538500,97778356
1592,"The Thin Red Line",1998,36400491,61308543,97709034
1593,"13 Going On 30",2004,57139723,40518989,97658712
1594,"The Book of Life",2014,50151543,47500000,97651543
1595,"A Simple Favor",2018,53548586,44080131,97628717
1596,"The Man with the Golden Gun",1974,21000000,76600000,97600000
1597,"Kick-Ass",2010,48071303,49459831,97531134
1598,"Green Zone",2010,35497337,62025683,97523020
1599,"42",2013,95020213,2450488,97470701
1600,"Once Upon a Time in Mexico",2003,56330657,41082870,97413527
1601,"Inspector Gadget",1999,97387965,0,97387965
1602,"The Rite",2011,33047633,64096354,97143987
1603,"Yao Mao Zhuan",2017,0,97033612,97033612
1604,"The Hours",2002,41675994,55354474,97030468
1605,"Enemy at the Gates",2001,51396781,45574512,96971293
1606,"Jarhead",2005,62647540,34300000,96947540
1607,"Assassination",2015,1904682,95028679,96933361
1608,"The Shack",2017,57386418,39522040,96908458
1609,"Ballerina",2016,21858070,75048370,96906440
1610,"Star Trek VI: The Undiscovered Country",1991,74888996,22011004,96900000
1611,"Xiong Chu Mei Zhi Bian Xing Ji",2018,0,96755799,96755799
1612,"My Sister's Keeper",2009,49200230,47472772,96673002
1613,"Red Eye",2005,57891803,38774683,96666486
1614,"The Lucky One",2012,60457138,36176695,96633833
1615,"Di Renjie zhi shendu longwang",2013,87783,96400000,96487783
1616,"Christmas with the Kranks",2004,73701902,22767285,96469187
1617,"Tammy",2014,84525432,11882223,96407655
1618,"8MM",1999,36443442,59955384,96398826
1619,"The Stepford Wives",2004,59475623,36746348,96221971
1620,"The Manchurian Candidate",2004,65948711,30200000,96148711
1621,"The Tigger Movie",2000,45542421,50605267,96147688
1622,"TMNT",2007,54149098,41946920,96096018
1623,"Dolphin Tale",2011,72286779,23781945,96068724
1624,"The 6th Day",2000,34543701,61481197,96024898
1625,"Scream 4",2011,38180928,57808662,95989590
1626,"Harlem Nights",1989,60857262,35000000,95857262
1627,"Star Trek II: The Wrath of Khan",1982,78912963,16887037,95800000
1628,"Poltergeist",2015,47425125,48287944,95713069
1629,"Underworld",2003,51970690,43737767,95708457
1630,"Some Like It Hot",2016,42230,95655578,95697808
1631,"The Butterfly Effect",2004,57924679,37713913,95638592
1632,"P.K.",2014,10616104,85000000,95616104
1633,"Killers",2010,47059963,48512786,95572749
1634,"Shooter",2007,47003582,48534978,95538560
1635,"Peter Pan",2003,48417850,46837635,95255485
1636,"Steel Magnolias",1989,83759091,11392847,95151938
1637,"Truth or Dare",2018,41411015,53716329,95127344
1638,"Old Dogs",2009,49492060,45612244,95104304
1639,"40 Days and 40 Nights",2002,37939782,57152885,95092667
1640,"The Guardian",2006,55011732,39961808,94973540
1641,"Shou Ji Kuang Xiang",2018,0,94951615,94951615
1642,"Be Cool",2005,55849401,39094616,94944017
1643,"HouseSitter",1992,58500635,36400000,94900635
1644,"The Lovely Bones",2009,44114232,50780216,94894448
1645,"1941",1979,34175000,60700000,94875000
1646,"Sha po long 2",2015,0,94809560,94809560
1647,"Riddick",2013,42025135,52738623,94763758
1648,"The Wedding Planner",2001,60400856,34327673,94728529
1649,"Silent Hill",2006,46982632,47721595,94704227
1650,"Role Models",2008,67300955,27199871,94500826
1651,"The Hundred-Foot Journey",2014,54235441,40035047,94270488
1652,"The River Wild",1994,46815000,47400000,94215000
1653,"Southpaw",2015,52421953,41734503,94156456
1654,"The Favourite",2018,34366783,59762629,94129412
1655,"Safe Haven",2013,71399120,22651831,94050951
1656,"Blockers",2018,60311495,33733833,94045328
1657,"Cong cong na nian",2014,566853,93470000,94036853
1658,"Forces of Nature",1999,52957800,41000000,93957800
1659,"The Internship",2013,44672764,49000000,93672764
1660,"Der Untergang",2005,5501940,88129804,93631744
1661,"Lady and the Tramp",1955,93600000,0,93600000
1662,"The Color Purple",1985,93589701,0,93589701
1663,"Money Monster",2016,41012075,52454020,93466095
1664,"Speed Racer",2008,43945766,49448696,93394462
1665,"The Poseidon Adventure",1972,93300000,0,93300000
1666,"Goosebumps 2: Haunted Halloween",2018,46697321,46594157,93291478
1667,"Calendar Girls",2003,31011616,62063000,93074616
1668,"Michael Clayton",2007,49033882,43953769,92987651
1669,"When Harry Met Sally…",1989,92823546,138414,92961960
1670,"Deuce Bigalow: Male Gigolo",1999,65535067,27400000,92935067
1671,"House of Flying Daggers",2004,11050094,81813851,92863945
1672,"Singwa Hamgge: Ingwa Yeon",2018,1200246,91599660,92799906
1673,"Xin xijù zhi wáng",2019,0,92796952,92796952
1674,"Syriana",2005,50824620,41866339,92690959
1675,"The Last Song",2010,62950384,29728564,92678948
1676,"Friday the 13th",2009,65002019,27668218,92670237
1677,"Gwoemul",2007,2201923,90416194,92618117
1678,"BlacKkKlansman",2018,49275340,43331643,92606983
1679,"I Am Sam",2001,40270895,52271523,92542418
1680,"Four Brothers",2005,74494381,18000000,92494381
1681,"The Family Stone",2005,60062868,32294631,92357499
1682,"I Love You, Man",2009,72013010,20289492,92302502
1683,"The Skeleton Key",2005,47907715,44349203,92256918
1684,"Secret Window",2004,47958031,44153520,92111551
1685,"My Big Fat Greek Wedding 2",2016,59689605,32406953,92096558
1686,"White Noise",2005,56094360,36000000,92094360
1687,"Spotlight",2015,45055776,47032684,92088460
1688,"No Reservations",2007,43107979,48835977,91943956
1689,"Treasure Planet",2002,38120554,53679446,91800000
1690,"Red Riding Hood",2011,37662162,54016280,91678442
1691,"Ben-Hur",2016,26410477,65259171,91669648
1692,"Masquerade",1988,15855828,75737916,91593744
1693,"I Feel Pretty",2018,48795601,42758196,91553797
1694,"Get Him to the Greek",2010,61153526,30302349,91455875
1695,"Drag Me To Hell",2009,42100625,49287862,91388487
1696,"Office Christmas Party",2016,54767494,36555805,91323299
1697,"The Purge",2013,64473115,26793466,91266581
1698,"Back to School",1986,91258000,0,91258000
1699,"Season of the Witch",2011,24827228,66299372,91126600
1700,"Romeo Must Die",2000,55973336,35063424,91036760
1701,"Gwanghae, Wangyidoen namja",2012,922921,89990223,90913144
1702,"Paranormal Activity: The Marked Ones",2014,32462372,58442482,90904854
1703,"Book Club",2018,68566296,22258216,90824512
1704,"The Karate Kid",1984,90815558,0,90815558
1705,"White Men Can't Jump",1992,76253806,14500000,90753806
1706,"Kangaroo Jack",2003,66723216,24000000,90723216
1707,"Autumn in New York",2000,37752931,52964753,90717684
1708,"Jing Zhou",2018,0,90706523,90706523
1709,"King Kong",1976,52614445,38000000,90614445
1710,"Burlesque",2010,39440655,51112020,90552675
1711,"Galaxy Quest",1999,71423726,19100000,90523726
1712,"Madea Goes To Jail",2009,90508336,0,90508336
1713,"Veteran",2015,1155652,89342778,90498430
1714,"The Tale of Despereaux",2008,50877145,39605172,90482317
1715,"Bring it On",2000,68353550,22100000,90453550
1716,"Trading Places",1983,90400000,0,90400000
1717,"Final Destination 2",2003,46896664,43500000,90396664
1718,"The Second Best Exotic Marigold Hotel",2015,33078266,57306040,90384306
1719,"Bedazzled",2000,37879996,52496228,90376224
1720,"This is 40",2012,67544505,22676677,90221182
1721,"Di Ren Jie Zhi Si Da Tian Wang",2018,262963,89772584,90035547
1722,"Mysteries of Egypt",1998,40593286,49406714,90000000
1723,"Racing Stripes",2005,49772522,40183018,89955540
1724,"Rien à déclarer",2011,182295,89752438,89934733
1725,"Marmaduke",2010,33644788,56251142,89895930
1726,"Sucker Punch",2011,36392502,53365887,89758389
1727,"In the Heart of the Sea",2015,25020758,64672551,89693309
1728,"Line Walker",2016,0,89565024,89565024
1729,"Anchorman: The Legend of Ron Burgundy",2004,84136909,5339356,89476265
1730,"Stigmata",1999,50041732,39400000,89441732
1731,"Father of the Bride",1991,89325780,0,89325780
1732,"About Time",2013,15323921,73985257,89309178
1733,"Fracture",2007,39004700,50200000,89204700
1734,"Underworld 3: Rise of the Lycans",2009,45802315,43300000,89102315
1735,"The Trial of Billy Jack",1974,89000000,0,89000000
1736,"The Transporter 2",2005,43095856,45882602,88978458
1737,"Rumor Has It",2005,42996140,45937422,88933562
1738,"State of Play",2009,37017955,51814255,88832210
1739,"La Môme",2007,10299782,78312055,88611837
1740,"The Cider House Rules",1999,57547209,31000000,88547209
1741,"What to Expect When You're Expecting",2012,41152203,47320813,88473016
1742,"Brave Hearts Umizaru",2012,0,88331372,88331372
1743,"Shanghai Knights",2003,60470220,27846615,88316835
1744,"Deep Sea 3D",2006,46373603,41778182,88151785
1745,"Snowpiercer",2013,4563029,83506851,88069880
1746,"The Hand That Rocks the Cradle",1992,88036683,0,88036683
1747,"Match Point",2005,23089926,64883909,87973835
1748,"Chasing the Dragon",2017,456854,87512183,87969037
1749,"Deliver Us from Evil",2014,30577122,57379496,87956618
1750,"Spawn",1997,54979992,32969867,87949859
1751,"Max Payne",2008,40689393,47085657,87775050
1752,"Sinister",2012,48086903,39640904,87727807
1753,"Ali",2001,58183966,29500000,87683966
1754,"Sherlock Gnomes",2018,43242871,44284780,87527651
1755,"R.V.",2006,71724497,15748527,87473024
1756,"Bicentennial Man",1999,58220776,29200000,87420776
1757,"Peter Pan",1953,87400000,0,87400000
1758,"Volver",2006,12899867,74326746,87226613
1759,"Hall Pass",2011,45060734,42112741,87173475
1760,"The Lincoln Lawyer",2011,58009200,29135886,87145086
1761,"The Shaggy Dog",2006,61123569,26000000,87123569
1762,"Sabrina",1995,53458319,33641681,87100000
1763,"Taeksi Woonjunsa",2017,1527829,85541895,87069724
1764,"El Laberinto del Fauno",2006,37634615,49406954,87041569
1765,"Star Trek III: The Search for Spock",1984,76471046,10528954,87000000
1766,"Dodookdeul",2012,532699,86427833,86960532
1767,"The Naked Gun 2½: The Smell of Fear",1991,86930411,0,86930411
1768,"Li Cha De Gu Ma",2018,0,86876449,86876449
1769,"Epic Movie",2007,39739367,47119211,86858578
1770,"Dinner for Schmucks",2010,73026337,13770165,86796502
1771,"Oceans",2010,19422319,67365211,86787530
1772,"A Million Ways to Die in The West",2014,42720965,44057592,86778557
1773,"Old School",2003,75155000,11610463,86765463
1774,"Abduction",2011,28087155,58561204,86648359
1775,"Rat Race",2001,56607223,30000000,86607223
1776,"The Kingdom",2007,47467250,39042352,86509602
1777,"The Amityville Horror",1979,86432520,0,86432520
1778,"Jing cha gu shi er ling yi san",2013,0,86340000,86340000
1779,"The Constant Gardener",2005,33579798,52721801,86301599
1780,"Young Frankenstein",1974,86300000,0,86300000
1781,"War Dogs",2016,43034523,43199980,86234503
1782,"The Inbetweeners",2012,35955,86015365,86051320
1783,"The Cell",2000,61280963,24630263,85911226
1784,"Tears of the Sun",2003,43632458,42000000,85632458
1785,"Dà Yú Hai Táng",2016,0,85571198,85571198
1786,"The Whole Nine Yards",2000,57262492,28265375,85527867
1787,"I Can Only Imagine",2018,83482352,1981338,85463690
1788,"Paper Towns",2015,32000304,53450180,85450484
1789,"The Ten Commandments",1956,85400591,33925,85434516
1790,"Rookies",2008,0,85405510,85405510
1791,"Overboard",2018,50316123,35053707,85369830
1792,"Collateral Beauty",2016,31016021,54293072,85309093
1793,"Stripes",1981,85300000,0,85300000
1794,"Jackass: Number Two",2006,72778712,12500000,85278712
1795,"Mortal Engines",2018,15951040,69322555,85273595
1796,"Xie Bu Ya Zheng",2018,0,85170584,85170584
1797,"Date Movie",2006,48548426,36597739,85146165
1798,"Final Fantasy: The Spirits Within",2001,32131830,53000000,85131830
1799,"Long men fei jia",2012,170276,84960442,85130718
1800,"Pet Sematary",2019,49583000,35493311,85076311
1801,"Das Boot",1982,11487676,73482661,84970337
1802,"Robin Hood",2018,30824628,53922813,84747441
1803,"Meet the Spartans",2008,38233676,46413155,84646831
1804,"J. Edgar",2011,37306030,47300000,84606030
1805,"Ao men feng yun",2014,0,84570000,84570000
1806,"Sicario",2015,46889293,37504456,84393749
1807,"Pinocchio",1940,84300000,0,84300000
1808,"7-beon-bang-ui seon-mul",2013,0,84164423,84164423
1809,"Priest",2011,29136626,55017400,84154026
1810,"The Parent Trap",1998,66308518,17668900,83977418
1811,"Les Bronzés 3: amis pour la vie",2006,0,83833602,83833602
1812,"The Illusionist",2006,39868642,43923420,83792062
1813,"The Goodbye Girl",1977,83700000,0,83700000
1814,"The War of the Roses",1989,83699711,0,83699711
1815,"Piranha 3D",2010,25003155,58657005,83660160
1816,"Snatch",2000,30093107,53500000,83593107
1817,"Point Break",1991,43218387,40313571,83531958
1818,"Les Choristes",2004,3629758,79900000,83529758
1819,"Airplane!",1980,83453539,0,83453539
1820,"Fantasia",1940,83320000,0,83320000
1821,"Assassins",1995,30306268,53000000,83306268
1822,"Blow",2001,52990775,30291521,83282296
1823,"In & Out",1997,63826569,19400000,83226569
1824,"Sky High",2005,63939454,19169905,83109359
1825,"Dead Man Walking",1995,39387284,43701011,83088295
1826,"Zodiac",2007,33080084,50000000,83080084
1827,"The Strangers",2008,52597610,30454066,83051676
1828,"Beijing yù shàng xi ya tú",2013,0,82984614,82984614
1829,"28 Days Later…",2003,45064915,37890718,82955633
1830,"The Possession",2012,49130588,33794476,82925064
1831,"Rings",2017,27793018,55124265,82917283
1832,"Once Upon a Time",2017,485728,82406221,82891949
1833,"Edge of Darkness",2010,43313890,39498566,82812456
1834,"Firewall",2006,48751189,34000000,82751189
1835,"Savages",2012,47323100,35190390,82513490
1836,"Act of Valor",2012,70012847,12484188,82497035
1837,"La famille Bélier",2014,0,82438670,82438670
1838,"Carrie",2013,35266619,47142901,82409520
1839,"Men of Honor",2000,48814909,33524574,82339483
1840,"Big Mommas: Like Father, Like Son",2011,37915414,44417036,82332450
1841,"Hostel",2006,47326473,34914637,82241110
1842,"In Her Shoes",2005,32880591,49322439,82203030
1843,"Identity",2003,52131264,30052419,82183683
1844,"Hitman: Agent 47",2015,22467450,59715353,82182803
1845,"Elizabeth",1998,30082699,52067943,82150642
1846,"Reign of Fire",2002,43061982,39088201,82150183
1847,"Letters to Juliet",2010,53032453,29116085,82148538
1848,"Catwoman",2004,40202379,41943000,82145379
1849,"Our Times",2015,0,82015701,82015701
1850,"On Her Majesty's Secret Service",1969,22800000,59200000,82000000
1851,"The Land Before Time",1988,48092846,33880000,81972846
1852,"Ouija: Origin of Evil",2016,35144505,46687361,81831866
1853,"Hot Fuzz",2007,23618786,58123832,81742618
1854,"Midnight Run",1988,38413606,43200000,81613606
1855,"M*A*S*H",1970,81600000,0,81600000
1856,"Hope Floats",1998,60110313,21418687,81529000
1857,"Arthur",1981,81464486,0,81464486
1858,"Premonition",2007,47852604,33608739,81461343
1859,"Zhan Lang",2015,0,81461069,81461069
1860,"Tinker Tailor Soldier Spy",2011,24149393,57303418,81452811
1861,"Vampires Suck",2010,36661504,44763484,81424988
1862,"Drive",2011,35060689,46297241,81357930
1863,"Waiting to Exhale",1995,66947948,14400000,81347948
1864,"Yi bu zhi yao",2014,0,81300000,81300000
1865,"Pain & Gain",2013,49875291,31400000,81275291
1866,"Dying Young",1991,32669178,48595295,81264473
1867,"Apocalypse Now",1979,78800000,2450485,81250485
1868,"The Grey",2012,51580136,29669040,81249176
1869,"Underworld: Blood Wars",2016,30353973,50855249,81209222
1870,"Fried Green Tomatoes",1991,81204830,0,81204830
1871,"Police Academy",1984,81198894,0,81198894
1872,"Das Leben der Anderen",2007,11284657,69912390,81197047
1873,"Frankenweenie",2012,35287788,45863000,81150788
1874,"Ai qing gong yu",2018,0,81096320,81096320
1875,"Duplicity",2009,40572825,40506741,81079566
1876,"The Rundown",2003,47641743,33190150,80831893
1877,"Sinbad: Legend of the Seven Seas",2003,26483452,54284432,80767884
1878,"Spy Kids: All the Time in the World",2011,38536376,42144807,80681183
1879,"Moonstruck",1987,80640528,0,80640528
1880,"A Dog’s Way Home",2019,41952715,38657869,80610584
1881,"Hannibal Rising",2007,27669725,52913586,80583311
1882,"Fiddler on the Roof",1971,80500000,0,80500000
1883,"The Rookie",2002,75600072,4891444,80491516
1884,"Did You Hear About the Morgans?",2009,29580087,50900479,80480566
1885,"The Game",1997,48265581,32104389,80369970
1886,"30 Days of Night",2007,39568996,40707160,80276156
1887,"Fame",2009,22455510,57772109,80227619
1888,"The Wedding Ringer",2015,64460211,15711385,80171596
1889,"Den of Thieves",2018,44947622,35183769,80131391
1890,"Finding Forrester",2000,51768623,28245000,80013623
1891,"Footloose",1984,80000000,0,80000000
1892,"Exit Wounds",2001,51758599,28200000,79958599
1893,"Dragon Wars: D-War",2007,10977721,68937640,79915361
1894,"Eiga Doraemon Nobita no Takarajima",2018,0,79904554,79904554
1895,"The Golden Child",1986,79817937,0,79817937
1896,"Earthquake",1974,79700000,0,79700000
1897,"Revolutionary Road",2008,22951340,56653480,79604820
1898,"Good Bye, Lenin!",2004,4063859,75320680,79384539
1899,"Nights in Rodanthe",2008,41850659,37500000,79350659
1900,"Muppets Most Wanted",2014,51178893,28133408,79312301
1901,"Jackass: The Movie",2002,64282312,15000000,79282312
1902,"El orfanato",2007,7159147,72091046,79250193
1903,"Tiny Times 4.0",2015,0,79230000,79230000
1904,"Sha Po Lang: Tan Lang",2017,0,79214896,79214896
1905,"Conan the Barbarian",1982,38264085,40850000,79114085
1906,"R.I.P.D.",2013,33618855,45457823,79076678
1907,"Showtime",2002,37948765,41000000,78948765
1908,"From Russia With Love",1964,24800000,54100000,78900000
1909,"The Attacks of 26/11",2013,248346,78631232,78879578
1910,"Fack ju Göthe",2013,0,78792492,78792492
1911,"Code Blue the Movie",2018,0,78778560,78778560
1912,"Orphan",2009,41596251,37173177,78769428
1913,"The Haunting in Connecticut",2009,55389516,23369006,78758522
1914,"Going in Style",2017,45018541,33654038,78672579
1915,"Teenage Mutant Ninja Turtles II: The Secret of …",1991,78656813,0,78656813
1916,"The Boss",2016,63077560,15574647,78652207
1917,"Scary Movie V",2013,32015787,46598194,78613981
1918,"Lady Bird",2017,48958273,29652496,78610769
1919,"Righteous Kill",2008,40081410,38400000,78481410
1920,"If I Stay",2014,50474843,27881327,78356170
1921,"Collateral Damage",2002,40048332,38305176,78353508
1922,"The Other Boleyn Girl",2008,26814957,51455013,78269970
1923,"Cocktail",1988,78222753,0,78222753
1924,"The Unborn",2009,42670410,35538402,78208812
1925,"The Sentinel",2006,36280697,41800000,78080697
1926,"The Naked Gun: From the Files of Police Squad!",1988,78041829,0,78041829
1927,"The Terminator",1984,38019031,40000000,78019031
1928,"Paranormal Activity: The Ghost Dimension",2015,18297124,59662250,77959374
1929,"Zuo Er",2015,0,77910000,77910000
1930,"Ocho Apellidos Vascos",2014,0,77862751,77862751
1931,"Step Up All In",2014,14904384,62900000,77804384
1932,"The Ides of March",2011,40962534,36773391,77735925
1933,"Manchester by the Sea",2016,47695371,30038496,77733867
1934,"Hostage",2005,34636443,43000000,77636443
1935,"United 93",2006,31567134,46067901,77635035
1936,"Windtalkers",2002,40914068,36714197,77628265
1937,"The Number 23",2007,35193167,42400000,77593167
1938,"Out of Sight",1998,37562568,40000000,77562568
1939,"Kubo and the Two Strings",2016,48023088,29525034,77548122
1940,"Halloween",2007,58269151,19245250,77514401
1941,"Serendipity",2001,50255310,27221987,77477297
1942,"The Ladykillers",2004,39692139,37700000,77392139
1943,"Something to Talk About",1995,50865589,26441637,77307226
1944,"Diary of a Wimpy Kid: Dog Days",2012,49008662,28221033,77229695
1945,"Money Train",1995,35324232,41900000,77224232
1946,"Mirrors",2008,30691439,46529157,77220596
1947,"There Will Be Blood",2007,40222514,36986197,77208711
1948,"Bad Santa",2003,60060328,17086703,77147031
1949,"The Spy Who Dumped Me",2018,33562069,43547888,77109957
1950,"Barbershop",2002,75781642,1281819,77063461
1951,"Boonie Bears: Entangled Worlds",2017,0,77026851,77026851
1952,"Tag",2018,54730625,22295561,77026186
1953,"Byeon-ho-in",2013,0,76988372,76988372
1954,"Diary of a Wimpy Kid",2010,64003625,12950686,76954311
1955,"Man cheng jin dai huang jin jia",2006,6566773,70337656,76904429
1956,"Coach Carter",2005,67264877,9400630,76665507
1957,"The Muppet Movie",1979,76657000,0,76657000
1958,"Father of the Bride Part II",1995,76578911,0,76578911
1959,"Tiger Zinda Hai",2017,5560921,70959455,76520376
1960,"Home on the Range",2004,50026353,26456108,76482461
1961,"Stealth",2005,32116746,44300000,76416746
1962,"The Mechanic",2011,29121498,47225895,76347393
1963,"The Untouchables",1987,76270454,0,76270454
1964,"Cocoon",1985,76257348,0,76257348
1965,"Cruel Intentions",1999,38665260,37573641,76238901
1966,"John Wick",2014,43037835,33197166,76235001
1967,"Easy A",2010,58401464,17799257,76200721
1968,"The Judge",2014,47119388,29000000,76119388
1969,"The Book Thief",2013,21488481,54598230,76086711
1970,"The Change-Up",2011,37243418,38753649,75997067
1971,"The Mortal Instruments: City of Bones",2013,31165421,44800146,75965567
1972,"48 Hrs.",1982,75936265,0,75936265
1973,"Mike and Dave Need Wedding Dates",2016,46009673,29888427,75898100
1974,"Sicario: Day of the Soldado",2018,50065850,25819346,75885196
1975,"Tin Cup",1996,53854588,22000000,75854588
1976,"O Brother, Where Art Thou?",2000,45506619,30257195,75763814
1977,"Dreamcatcher",2003,33685268,42000000,75685268
1978,"Shin Godjira",2016,1908028,73704456,75612484
1979,"Stomp the Yard",2007,61356221,14169497,75525718
1980,"The Last of the Mohicans",1992,75505856,0,75505856
1981,"Xiao shi dai 3",2014,0,75490000,75490000
1982,"The Count of Monte Cristo",2002,54228104,21160986,75389090
1983,"Thermae Romae",2012,0,75387554,75387554
1984,"Searching",2018,26015149,49356127,75371276
1985,"The Back-up Plan",2010,37490007,37791172,75281179
1986,"The Nightmare Before Christmas",1993,75069160,201941,75271101
1987,"Crimson Peak",2015,31090320,43876534,74966854
1988,"Wonder Park",2019,44576000,30300000,74876000
1989,"Elizabeth: The Golden Age",2007,16285240,58585626,74870866
1990,"Dongwu shijie",2018,0,74842075,74842075
1991,"The Prince of Tides",1991,74787599,0,74787599
1992,"Jackie Brown",1997,39673162,35054330,74727492
1993,"Padmavati",2018,11846060,62784891,74630951
1994,"I, Frankenstein",2014,19075290,55500000,74575290
1995,"Bend it Like Beckham",2003,32543449,42022593,74566042
1996,"WarGames",1983,74433837,0,74433837
1997,"Tyler Perry’s A Madea Family Funeral",2019,72989234,1406555,74395789
1998,"To Rome with Love",2012,16684352,57641663,74326015
1999,"The Kite Runner",2007,15800078,58380667,74180745
2000,"Escape From Planet Earth",2013,57012977,17143633,74156610
2001,"The Core",2003,31111260,43021371,74132631
2002,"War Room",2015,67790117,6185122,73975239
2003,"Obsessed",2009,68261644,5703069,73964713
2004,"The Hurricane",1999,50699241,23257000,73956241
2005,"Beetlejuice",1988,73839613,47933,73887546
2006,"Widows",2018,42402632,31463456,73866088
2007,"The Divine Secrets of the Ya-Ya Sisterhood",2002,69586544,4240224,73826768
2008,"The Pirate Fairy",2014,0,73816079,73816079
2009,"Quo Vado?",2016,0,73811841,73811841
2010,"Miracles from Heaven",2016,61705123,12093613,73798736
2011,"Diary of a Wimpy Kid: Rodrick Rules",2011,52698535,20996659,73695194
2012,"The Jerk",1979,73691419,0,73691419
2013,"Next",2007,18211013,55380487,73591500
2014,"Sanju",2018,7909317,65616927,73526244
2015,"Life",1999,64062587,9459000,73521587
2016,"Brick Mansions",2014,20396829,53024395,73421224
2017,"Astérix: Le secret de la potion magique",2018,0,73249936,73249936
2018,"Here Comes the Boom",2012,45290318,27948940,73239258
2019,"Tyler Perry’s Boo! A Madea Halloween",2016,73206343,0,73206343
2020,"Dude, Where's My Car?",2000,46729374,26450923,73180297
2021,"Tong zhuo de ni",2014,0,73050000,73050000
2022,"Superhero Movie",2008,26638520,46387782,73026302
2023,"Ben-Hur",1959,73000000,0,73000000
2024,"Hana yori dango: Fainaru",2008,0,73000000,73000000
2025,"Sultan",2016,5599781,67390000,72989781
2026,"The Best Man Holiday",2013,70525195,2310515,72835710
2027,"Lady in the Water",2006,42285169,30500000,72785169
2028,"The One",2001,43905746,28783380,72689126
2029,"Manbiki kazoku",2018,3302643,69360250,72662893
2030,"Urban Legend",1998,38116707,34455157,72571864
2031,"Eternal Sunshine of the Spotless Mind",2004,34366518,38204244,72570762
2032,"Death Race",2008,36316032,36200787,72516819
2033,"Li hai le, wo de guo",2018,0,72506344,72506344
2034,"Tunnel",2016,568876,71891456,72460332
2035,"Yours, Mine and Ours",2005,53359917,19000000,72359917
2036,"Colombiana",2011,36665854,35629408,72295262
2037,"Problem Child",1990,53470891,18800004,72270895
2038,"Always",1989,41843630,30300000,72143630
2039,"My Fair Lady",1964,72000000,71636,72071636
2040,"Around the World in 80 Days",2004,24004159,48000000,72004159
2041,"2001: A Space Odyssey",1968,59936321,11991725,71928046
2042,"Funny People",2009,51855045,20025260,71880305
2043,"Small Soldiers",1998,55143823,16600000,71743823
2044,"Rules of Engagement",2000,61322858,10397073,71719931
2045,"Ruthless People",1986,71624879,0,71624879
2046,"3 Men and a Little Lady",1990,71609321,0,71609321
2047,"Sammy's avonturen: De geheime doorgang",2010,0,71594792,71594792
2048,"Trainspotting",1996,16501785,55057186,71558971
2049,"Bandits",2001,41523271,30000000,71523271
2050,"Grumpier Old Men",1995,71518503,0,71518503
2051,"What Dreams May Come",1998,55485043,16000000,71485043
2052,"The Royal Tenenbaums",2001,52353636,19077240,71430876
2053,"The House Bunny",2008,48237389,23153212,71390601
2054,"National Lampoon's Christmas Vacation",1989,71319546,0,71319546
2055,"Holes",2003,67383924,3848290,71232214
2056,"Shanghai Noon",2000,56932305,14257530,71189835
2057,"Down to Earth",2001,64172251,7000000,71172251
2058,"3:10 to Yuma",2007,53606916,17564909,71171825
2059,"12 Strong",2018,45819713,25298665,71118378
2060,"Turner & Hooch",1989,71079915,0,71079915
2061,"XXX: State of the Union",2005,26873932,44200000,71073932
2062,"Curious George",2006,58640119,12412485,71052604
2063,"The Counselor",2013,16973715,54035619,71009334
2064,"Anna Karenina",2012,12816367,58188260,71004627
2065,"Cleopatra",1963,57000000,14000000,71000000
2066,"Son of God",2014,59700064,11249729,70949793
2067,"Kate and Leopold",2001,47095453,23842325,70937778
2068,"Groundhog Day",1993,70906973,0,70906973
2069,"I Am not Madame Bovary",2016,436798,70403856,70840654
2070,"Shallow Hal",2001,70836296,0,70836296
2071,"Five Feet Apart",2019,45087093,25704807,70791900
2072,"The Grudge 2",2006,39143839,31600000,70743839
2073,"Hannah Montana/Miley Cyrus: Best of Both Worlds…",2008,65281781,5430318,70712099
2074,"Flickan som lekte med elden",2009,9081782,61615330,70697112
2075,"Ronin",1998,41610884,29081217,70692101
2076,"The Cabin in the Woods",2012,42073277,28616691,70689968
2077,"Any Which Way You Can",1980,70687344,0,70687344
2078,"Nerve",2016,38583626,32068658,70652284
2079,"Takers",2010,57744720,12842548,70587268
2080,"One Piece Film Z",2012,0,70569231,70569231
2081,"Qu'est-ce qu'on a encore fait au bon dieu?",2019,0,70568000,70568000
2082,"The Dilemma",2011,48475290,22071575,70546865
2083,"Delivery Man",2013,30659817,39877053,70536870
2084,"Odoru Daisôsasen the Final: Aratanaru kibô",2012,0,70519044,70519044
2085,"Stop! Or My Mom Will Shoot",1992,28411000,42000000,70411000
2086,"The Hills Have Eyes",2006,41778863,28576950,70355813
2087,"Anacondas: The Hunt for the Blood Orchid",2004,31526393,38800000,70326393
2088,"Babylon A.D.",2008,22532572,47683925,70216497
2089,"Star Trek V: The Final Frontier",1989,52210049,17989951,70200000
2090,"License to Wed",2007,43799818,26387270,70187088
2091,"Grumpy Old Men",1993,70172621,0,70172621
2092,"The Last Exorcism",2010,41034350,29131550,70165900
2093,"A Cinderella Story",2004,51438175,18725930,70164105
2094,"Ferris Bueller's Day Off",1986,70136369,1469,70137838
2095,"Hereditary",2018,44069456,26064449,70133905
2096,"See You Tomorrow",2016,0,70065568,70065568
2097,"House of Wax",2005,32064800,38000000,70064800
2098,"Think Like a Man Too",2014,65028687,4999246,70027933
2099,"The Pink Panther 2",2009,35922978,34100000,70022978
2100,"Born on the Fourth of July",1989,70001698,0,70001698
2101,"Halloween",1978,47000000,23000000,70000000
2102,"Lawrence of Arabia",1962,37495385,32500000,69995385
2103,"What Men Want",2019,54611903,15300000,69911903
2104,"Private Benjamin",1980,69847348,0,69847348
2105,"Children of Men",2006,35552383,34292628,69845011
2106,"Tae Guik Gi: The Brotherhood of War",2004,1110186,68716522,69826708
2107,"The Call",2013,51872378,17949098,69821476
2108,"Sole A Catinelle",2013,0,69812795,69812795
2109,"Grudge Match",2013,29807260,40000000,69807260
2110,"The Brave One",2007,36793804,32998900,69792704
2111,"Un long dimanche de fiançailles",2004,6167817,63591479,69759296
2112,"Saw VI",2009,27693292,42059110,69752402
2113,"The Best Little Whorehouse in Texas",1982,69701637,0,69701637
2114,"The Transporter Refueled",2015,16029670,53668825,69698495
2115,"The Kid",2000,69688384,0,69688384
2116,"Hero",2007,0,69671205,69671205
2117,"Fantasia 2000 (Theatrical Release)",1999,69610858,7776,69618634
2118,"Dolphins",2000,54000000,15600000,69600000
2119,"Land of the Lost",2009,49438370,20110271,69548641
2120,"Because I Said So",2007,42674040,26864793,69538833
2121,"3 Idiots",2009,6533849,63000000,69533849
2122,"Vice",2018,47836282,21650739,69487021
2123,"The Adventures of Sharkboy and Lavagirl in 3-D",2005,39177684,30248282,69425966
2124,"13 Hours: The Secret Soldiers of Benghazi",2016,52853219,16558151,69411370
2125,"Bad Company",2002,30157016,39000000,69157016
2126,"Babe: Pig in the City",1998,18319860,50812000,69131860
2127,"The Age of Adaline",2015,42629776,26354760,68984536
2128,"Moonrise Kingdom",2012,45512466,23335980,68848446
2129,"Begin Again",2014,16170632,52668104,68838736
2130,"John Tucker Must Die",2006,41011711,27812815,68824526
2131,"Precious (Based on the Novel Push by Sapphire)",2009,47566524,21156324,68722848
2132,"Feng Ren Ji Yue Dui",2017,312537,68409784,68722321
2133,"From Hell",2001,31598308,37114057,68712365
2134,"Stalingrad",2013,1013945,67693174,68707119
2135,"Star Wars: The Clone Wars",2008,35161554,33533889,68695443
2136,"Open Range",2003,58331254,10282738,68613992
2137,"One Direction: This is Us",2013,28873374,39668412,68541786
2138,"Thirteen Ghosts",2001,41867960,26600000,68467960
2139,"Pokemon 3: The Movie",2001,17052128,51400000,68452128
2140,"Benpao Ba! Xiongdi",2015,309297,68110000,68419297
2141,"Purple Rain",1984,68392977,0,68392977
2142,"Ghost Ship",2002,30113491,38236393,68349884
2143,"Practical Magic",1998,46850558,21486439,68336997
2144,"American Assassin",2017,36249674,32060466,68310140
2145,"The Jewel of the Nile",1985,68275764,0,68275764
2146,"Skyline",2010,21416355,46848618,68264973
2147,"The Boy",2016,35819556,32401396,68220952
2148,"Hubble 3D",2010,52361823,15835777,68197600
2149,"Mr. Magorium's Wonder Emporium",2007,32061555,36130088,68191643
2150,"The X-Files: I Want to Believe",2008,20982478,47188314,68170792
2151,"Taxi",2004,36609966,31500000,68109966
2152,"Frequency",2000,44983704,23095967,68079671
2153,"Gedo Senki (Tales from Earthsea)",2010,48658,68000000,68048658
2154,"The American",2010,35606376,32344347,67950723
2155,"Letters from Iwo Jima",2006,13756082,54111916,67867998
2156,"Todo sobre mi madre",1999,8264530,59600000,67864530
2157,"Austin Powers: International Man of Mystery",1997,53883989,13800000,67683989
2158,"A Perfect Murder",1998,67658331,0,67658331
2159,"Legion",2010,40168080,27479494,67647574
2160,"Sudden Impact",1983,67642693,0,67642693
2161,"Prime",2005,22827153,44700000,67527153
2162,"He Yi Sheng Xiao Mo",2015,0,67458479,67458479
2163,"The Men Who Stare at Goats",2009,32428195,34920023,67348218
2164,"Runaway Jury",2003,49440996,17897223,67338219
2165,"Broadcast News",1987,51249404,16081905,67331309
2166,"Star Trek: Nemesis",2002,43254409,24058417,67312826
2167,"Chennai Express",2013,5307960,61975652,67283612
2168,"The Next Three Days",2010,21148651,46107265,67255916
2169,"When a Stranger Calls",2006,47860214,19355221,67215435
2170,"Boogeyman",2005,46752382,20440477,67192859
2171,"Coal Miner's Daughter",1980,67182787,0,67182787
2172,"The Watch",2012,34353000,32777045,67130045
2173,"Secret of the Wings",2012,0,67084376,67084376
2174,"Space Chimps",2008,30105968,36923988,67029956
2175,"The Secret of My Success",1987,66995000,0,66995000
2176,"Run All Night",2015,26461644,40500000,66961644
2177,"Tyler Perry's Madea's Witness Protection",2012,65653242,1297645,66950887
2178,"The Little Rascals",1994,51764950,15183000,66947950
2179,"102 Dalmatians",2000,66941559,0,66941559
2180,"Changing Lanes",2002,66790248,0,66790248
2181,"Hero",1992,19487173,47300000,66787173
2182,"Selma",2015,52076908,14699668,66776576
2183,"Uncle Buck",1989,66758538,0,66758538
2184,"Side Effects",2013,32172757,34569381,66742138
2185,"Inkheart",2009,17303424,49352514,66655938
2186,"Bai She: Yuan Qi",2019,0,66652780,66652780
2187,"Huo Yuan Jia",2006,24633730,42000000,66633730
2188,"Thirteen Days",2000,34566746,31987801,66554547
2189,"The Danish Girl",2015,11114018,55428886,66542904
2190,"Honig im Kipf",2014,0,66521876,66521876
2191,"The Godfather: Part III",1990,66520529,0,66520529
2192,"Geomsawejeon",2016,0,66336016,66336016
2193,"Victoria and Abdul",2017,22245070,44053661,66298731
2194,"Mile 22",2018,36108758,30186363,66295121
2195,"Meitantei Konan: Junkoku no naitomea",2016,0,66265957,66265957
2196,"Okuribito",2009,1543346,64600000,66143346
2197,"The Bank Job",2008,30060660,36082345,66143005
2198,"Smokey and the Bandit II",1980,66132626,0,66132626
2199,"Antarctica",1991,65000000,1070389,66070389
2200,"Fei Cheng Wu Rao 2",2010,182517,65826496,66009013
2201,"Fack ju Göhte 3",2017,0,65994485,65994485
2202,"Hot Tub Time Machine",2010,50269859,15697891,65967750
2203,"August Rush",2007,31664162,34217941,65882103
2204,"Barbershop 2: Back in Business",2004,65070412,772000,65842412
2205,"One Piece Film: Gold",2016,190859,65605166,65796025
2206,"Life of the Party",2018,53059911,12700000,65759911
2207,"Sweet November",2001,25288103,40466125,65754228
2208,"K-19: The Widowmaker",2002,35168966,30547160,65716126
2209,"Bei Jing Ai Qing Gu Shi",2014,423598,65290000,65713598
2210,"Ever After: A Cinderella Story",1998,65705772,0,65705772
2211,"The Road to El Dorado",2000,50802661,14897339,65700000
2212,"Stakeout",1987,65673233,0,65673233
2213,"Dan in Real Life",2007,47642963,18026038,65669001
2214,"16 Blocks",2006,36895141,28700000,65595141
2215,"Dao shi xia shan",2015,0,65545173,65545173
2216,"Witness",1985,65532576,0,65532576
2217,"The Ghost Writer",2010,15541549,49990942,65532491
2218,"The Hard Way",1991,24525330,41000000,65525330
2219,"Love, Simon",2018,40826341,24694292,65520633
2220,"Street Kings",2008,26418667,39039144,65457811
2221,"Killer Elite",2011,25124986,40284060,65409046
2222,"Take the Lead",2006,34742066,30648427,65390493
2223,"Hanna",2011,40259119,25084575,65343694
2224,"Donnie Brasco",1997,41954997,23348055,65303052
2225,"Jersey Boys",2014,47047013,18235719,65282732
2226,"Moonlight",2016,27854931,37390581,65245512
2227,"Jing Cheng 81 Hao",2014,0,65220000,65220000
2228,"Fort Apache, The Bronx",1981,29200000,36000000,65200000
2229,"Se jie",2007,4604982,60562448,65167430
2230,"Without a Paddle",2004,58156435,6964845,65121280
2231,"House on Haunted Hill",1999,40846082,24244459,65090541
2232,"Something Borrowed",2011,39046489,26037627,65084116
2233,"The Benchwarmers",2006,59843754,5219972,65063726
2234,"Underdog",2007,43760605,21272723,65033328
2235,"Song of the South",1946,65000000,0,65000000
2236,"Meitantei Konan: Kara Kurenai no Rabu Retta",2017,0,64956739,64956739
2237,"Mr. Mom",1983,64800000,0,64800000
2238,"The Living Sea",1995,64800000,0,64800000
2239,"Haeundae",2010,0,64733391,64733391
2240,"Nothing To Lose",1997,44480039,20114022,64594061
2241,"The Host",2013,26623701,37853350,64477051
2242,"Miracle",2004,64378093,96612,64474705
2243,"Field of Dreams",1989,64431625,0,64431625
2244,"Unfriended",2015,32789645,31574553,64364198
2245,"The Imaginarium of Doctor Parnassus",2009,7689607,56663000,64352607
2246,"Tropa de Elite 2: O Inimigo Agora É Outro",2011,100119,64207639,64307758
2247,"Fences",2016,57682904,6599977,64282881
2248,"Wag the Dog",1997,43057470,21194568,64252038
2249,"Monster",2003,34469210,29771603,64240813
2250,"28 Weeks Later",2007,28638916,35593798,64232714
2251,"Taking Lives",2004,32682342,31550021,64232363
2252,"Happy Death Day 2U",2019,28051045,36161517,64212562
2253,"Valiant",2005,19478106,44710281,64188387
2254,"Baby Mama",2008,60494212,3676235,64170447
2255,"Hail, Caesar!",2016,30080225,34080455,64160680
2256,"Eien No 0",2013,0,64071217,64071217
2257,"Zhong Kui fu mo: Xue yao mo ling",2015,165428,63870868,64036296
2258,"The Remains of the Day",1993,22954968,41000000,63954968
2259,"L Feng Bao",2018,0,63931005,63931005
2260,"Scent of a Woman",1992,63895607,0,63895607
2261,"The Longest Ride",2015,37446117,26356811,63802928
2262,"Working Girl",1988,63800000,0,63800000
2263,"High Crimes",2002,41543207,22237893,63781100
2264,"God’s Not Dead",2014,60755732,3021360,63777092
2265,"The Witches of Eastwick",1987,63749955,0,63749955
2266,"What About Bob?",1991,63710000,0,63710000
2267,"Cop Land",1997,44906632,18800000,63706632
2268,"Flags of Our Fathers",2006,33602376,30055565,63657941
2269,"Risky Business",1983,63541777,0,63541777
2270,"Stuck On You",2003,33832741,29704423,63537164
2271,"A Fish Called Wanda",1988,63493000,0,63493000
2272,"In Good Company",2004,45489752,18000000,63489752
2273,"She's All That",1999,63465522,0,63465522
2274,"Tango & Cash",1989,63408614,0,63408614
2275,"Conan the Barbarian",2011,21295021,42061112,63356133
2276,"Devil",2010,33679655,29674459,63354114
2277,"Madea's Family Reunion",2006,63257940,62581,63320521
2278,"Second Act",2018,39282227,24032834,63315061
2279,"Dave",1993,63270710,0,63270710
2280,"Lions for Lambs",2007,14998070,48213018,63211088
2281,"Random Hearts",1999,31054924,32145076,63200000
2282,"Kick-Ass 2",2013,28795985,34333924,63129909
2283,"A Star is Born",1976,63129898,0,63129898
2284,"Beavis and Butt-Head Do America",1996,63118386,0,63118386
2285,"Rising Sun",1993,63095271,0,63095271
2286,"The Sweetest Thing",2002,24430272,38648484,63078756
2287,"Jiàn gúo dà yè",2009,0,62995096,62995096
2288,"Footloose",2011,51802742,11187092,62989834
2289,"The Peacemaker",1997,41263140,21704228,62967368
2290,"Pirates",2014,160133,62723572,62883705
2291,"Piglet's Big Movie",2003,23103423,39767123,62870546
2292,"The Darkest Hour",2011,21443494,41388221,62831715
2293,"Proof of Life",2000,32598931,30162074,62761005
2294,"The Star",2017,40847995,21910015,62758010
2295,"Inside Men",2015,0,62698565,62698565
2296,"Honey",2003,30272254,32374509,62646763
2297,"The Mountain Between Us",2017,30348555,32268992,62617547
2298,"Cold Pursuit",2019,32138862,30469747,62608609
2299,"Splash",1984,62599495,0,62599495
2300,"Thunder and the House of Magic",2014,4091,62578429,62582520
2301,"How to Be a Latin Lover",2017,32149404,30406824,62556228
2302,"The Crying Game",1992,62546695,0,62546695
2303,"Perfect Stranger",2007,23760822,38765566,62526388
2304,"Patton",1970,62500000,0,62500000
2305,"Gwansang",2013,484112,62006230,62490342
2306,"Snow Day",2000,60008303,2444624,62452927
2307,"Like Mike",2002,51432423,11000000,62432423
2308,"Not Another Teen Movie",2001,37882551,24518792,62401343
2309,"Ek Tha Tiger",2012,2347774,60000000,62347774
2310,"47 Meters Down",2017,44307193,17960912,62268105
2311,"The Reaping",2007,25126214,37100000,62226214
2312,"Ninja Assassin",2009,38122883,24087009,62209892
2313,"Two Brothers",2004,19176754,43000000,62176754
2314,"Down and Out in Beverly Hills",1986,62134225,0,62134225
2315,"A Walk Among the Tombstones",2014,26017685,36090902,62108587
2316,"Captain Corelli's Mandolin",2001,25528495,36569000,62097495
2317,"Brooklyn",2015,38322743,23753398,62076141
2318,"28 Days",2000,37035515,25028457,62063972
2319,"Snakes on a Plane",2006,34020814,28000000,62020814
2320,"Keinohrhasen",2007,0,62000000,62000000
2321,"An American Werewolf in London",1981,31973249,30000000,61973249
2322,"Friday Night Lights",2004,61255921,694849,61950770
2323,"I Love Trouble",1994,30806194,31141073,61947267
2324,"Mouse Hunt",1997,61894591,0,61894591
2325,"Chariots of Fire",1981,61558162,307785,61865947
2326,"Bai Fa Mo Nu Zhuan Zhi Ming Yue Tian Guo",2015,0,61850000,61850000
2327,"Krampus",2015,42725475,19062918,61788393
2328,"The Tree of Life",2011,13305665,48416161,61721826
2329,"The 13th Warrior",1999,32698899,29000000,61698899
2330,"Monster Trucks",2016,33370166,28272632,61642798
2331,"The Five-Year Engagement",2012,28700285,32923534,61623819
2332,"Everything, Everything",2017,34121140,27481996,61603136
2333,"Umizaru 2: Limit of Love",2006,0,61600000,61600000
2334,"A History of Violence",2005,31493782,29984015,61477797
2335,"Cellular",2004,32003620,29472364,61475984
2336,"Larry Crowne",2011,35608245,25840890,61449135
2337,"Eiga Doraemon: Nobita no nankyoku kachikochi da…",2017,0,61403776,61403776
2338,"National Lampoon’s Vacation",1983,61400000,0,61400000
2339,"The Goonies",1985,61389680,0,61389680
2340,"Flatliners",1990,61308153,0,61308153
2341,"My Little Pony: The Movie",2017,21885107,39415751,61300858
2342,"The Walk",2015,10161183,51035862,61197045
2343,"Misery",1990,61158960,0,61158960
2344,"Rock of Ages",2012,38518613,22513319,61031932
2345,"Meitantei Conan: Goka no himawari",2015,0,60985674,60985674
2346,"Taxi 4",2007,0,60865364,60865364
2347,"Marie Antoinette",2006,15962471,44900000,60862471
2348,"Why Did I Get Married Too?",2010,60095852,735215,60831067
2349,"Zoolander",2001,45172250,15608731,60780981
2350,"My Super Ex-Girlfriend",2006,22530295,38242561,60772856
2351,"The Wild Thornberrys Movie",2002,40108697,20586040,60694737
2352,"Astérix et Obélix: Au service de Sa Majesté ",2012,0,60680125,60680125
2353,"Dallas Buyers Club",2013,27298285,33313560,60611845
2354,"The Founding of an Army",2017,0,60600360,60600360
2355,"Kiss the Girls",1997,60527873,0,60527873
2356,"Runner Runner",2013,19316646,41196034,60512680
2357,"Lord of War",2005,24149632,36288095,60437727
2358,"10 Things I Hate About You",1999,38177966,22235984,60413950
2359,"Secretariat",2010,59699513,676734,60376247
2360,"Beautiful Creatures",2013,19452138,40830738,60282876
2361,"I Spy",2002,33561137,26718685,60279822
2362,"The Perfect Guy",2015,57027435,3250731,60278166
2363,"The Insider",1999,28965197,31300000,60265197
2364,"Jiàn Dang Wei Yè",2011,151305,60096706,60248011
2365,"127 Hours",2010,18335230,41881941,60217171
2366,"Chain Reaction",1996,21226204,38983130,60209334
2367,"Les Rivières Pourpres",2001,632548,59500000,60132548
2368,"It's a Mad Mad Mad Mad World",1963,46300000,13700000,60000000
2369,"Spartacus",1960,30000000,30000000,60000000
2370,"Superman III",1983,59950623,0,59950623
2371,"Jungle 2 Jungle",1997,59925026,0,59925026
2372,"A Haunted House",2013,40041683,19880875,59922558
2373,"Son of the Mask",2005,17018422,42900000,59918422
2374,"Bai tuan da zhan",2015,0,59800000,59800000
2375,"Morning Glory",2010,31011732,28783338,59795070
2376,"Friday the 13th",1980,39754601,20000000,59754601
2377,"Next Friday",2000,57176582,2498725,59675307
2378,"21 Grams",2003,16248701,43418924,59667625
2379,"The Nice Guys",2016,36261763,23334984,59596747
2380,"Dr. No",1963,16067035,43500000,59567035
2381,"Aliens in the Attic",2009,25200412,34350871,59551283
2382,"Spies Like Us",1985,59526202,0,59526202
2383,"The Last Boy Scout",1991,59509925,0,59509925
2384,"Scrooged",1988,59450353,0,59450353
2385,"The Flintstones in Viva Rock Vegas",2000,35231365,24200000,59431365
2386,"The Devotion of Suspect X",2017,686435,58576718,59263153
2387,"Good Luck Chuck",2007,35017297,24166524,59183821
2388,"One Day",2011,13843771,45324921,59168692
2389,"Matchstick Men",2003,36873198,22292102,59165300
2390,"The Gift",2015,43787265,15191212,58978477
2391,"The Legend of Hercules",2014,18848538,40104781,58953319
2392,"Jeepers Creepers",2001,37904175,21034860,58939035
2393,"Far and Away",1992,58883840,0,58883840
2394,"Behind Enemy Lines",2001,58855732,0,58855732
2395,"Sliding Doors",1998,11911200,46897949,58809149
2396,"Chai dàn zhuanjia",2017,0,58807172,58807172
2397,"Doom",2005,28212337,30544841,58757178
2398,"Funny Girl",1968,58707416,0,58707416
2399,"Honey I Blew Up the Kid",1992,58662452,0,58662452
2400,"Jack",1996,58617334,0,58617334
2401,"Woman in Gold",2015,33307793,25278614,58586407
2402,"Sea of Love",1989,58571513,0,58571513
2403,"Zathura",2005,28045540,30500000,58545540
2404,"Invincible",2006,57806952,694175,58501127
2405,"Isle of Dogs",2018,32015231,26450570,58465801
2406,"Wangeui Namja",2005,0,58448744,58448744
2407,"Doragon bôru Z: Fukkatsu no 'F'",2015,8008363,50400000,58408363
2408,"Must Love Dogs",2005,43894863,14510450,58405313
2409,"The Ninth Gate",2000,18653746,39740562,58394308
2410,"Are We Done Yet?",2007,49662533,8725535,58388068
2411,"Chongqing Hot Pot",2016,776649,57604301,58380950
2412,"Little Nicky",2000,39442871,18827520,58270391
2413,"Amistad",1997,44212592,14037559,58250151
2414,"Bowling for Columbine",2002,21576018,36664469,58240487
2415,"Agent Cody Banks",2003,47545060,10695398,58240458
2416,"Dragonball Evolution",2009,9362785,48865675,58228460
2417,"Chong fan 20 sui",2014,0,58100000,58100000
2418,"That's My Boy",2012,36931089,21154146,58085235
2419,"My Girl",1991,58011485,0,58011485
2420,"The Inbetweeners 2",2014,0,58000000,58000000
2421,"Yi dai zong shi",2013,6594959,51392340,57987299
2422,"Snitch",2013,42930462,14977272,57907734
2423,"Adrift",2018,31445011,26452180,57897191
2424,"Snatched",2017,45852178,11999999,57852177
2425,"U.S. Marshals",1998,57833603,0,57833603
2426,"Dolphin Tale 2",2014,42024533,15800000,57824533
2427,"Heartbreakers",2001,40334024,17419801,57753825
2428,"Yao Ling Ling",2017,186135,57442237,57628372
2429,"Year One",2009,43337279,14267444,57604723
2430,"End of Watch",2012,41003371,16583235,57586606
2431,"The Eye",2008,31418697,26159068,57577765
2432,"Derailed",2005,36020063,21500000,57520063
2433,"The Cannonball Run",1981,57498710,0,57498710
2434,"Under the Tuscan Sun",2003,43601508,13888516,57490024
2435,"Pet Sematary",1989,57469179,0,57469179
2436,"The Nut Job 2: Nutty by Nature",2017,28370522,29067867,57438389
2437,"Dragnet",1987,57387000,0,57387000
2438,"The Specialist",1994,57362581,0,57362581
2439,"Sister Act 2 Back in the Habit",1993,57319029,0,57319029
2440,"The Godfather: Part II",1974,57300000,0,57300000
2441,"Milk",2008,31841299,25452072,57293371
2442,"Boyhood",2014,25379975,31893074,57273049
2443,"Willow",1988,57269863,0,57269863
2444,"Smokin' Aces",2007,35662731,21600709,57263440
2445,"The Blues Brothers",1980,57229890,0,57229890
2446,"Prom Night",2008,43869350,13324305,57193655
2447,"The Mist",2007,25593755,31595653,57189408
2448,"What's Up, Doc?",1972,57142740,0,57142740
2449,"Unlawful Entry",1992,57138719,0,57138719
2450,"Annie",1982,57059003,0,57059003
2451,"The Descent",2006,26024456,31026597,57051053
2452,"Beaches",1988,57041866,0,57041866
2453,"Evangelion Shin Gekijôban: Kyu",2012,0,57019825,57019825
2454,"Crossroads",2002,37188667,19811333,57000000
2455,"Beethoven",1992,56979478,0,56979478
2456,"The Man in the Iron Mask",1998,56968169,0,56968169
2457,"Elektra",2005,24409722,32414911,56824633
2458,"Into the Wild",2007,18354356,38468604,56822960
2459,"A Civil Action",1998,56709981,0,56709981
2460,"Guess Who's Coming to Dinner",1967,56700000,0,56700000
2461,"The Final Countdown",1980,16647800,40000000,56647800
2462,"Murder by Numbers",2002,31874869,24768398,56643267
2463,"Clueless",1995,56598476,0,56598476
2464,"Good Night, and Good Luck",2005,31501218,25085683,56586901
2465,"L.O.R.D: Legend of Ravaging Dynasties",2016,0,56515806,56515806
2466,"Remember Me",2010,19068240,37437880,56506120
2467,"Tombstone",1993,56505065,0,56505065
2468,"The Curse of La Llorona",2019,26505000,30000000,56505000
2469,"Confidential Assignment",2017,475618,55975045,56450663
2470,"The Crazies",2010,39123589,17321945,56445534
2471,"The Mothman Prophecies",2002,35228696,21209859,56438555
2472,"Cradle 2 the Grave",2003,34657731,21777211,56434942
2473,"Drumline",2002,56398162,0,56398162
2474,"15 Minutes",2001,24375436,31956428,56331864
2475,"Mu Hou Wan Jia",2018,0,56235548,56235548
2476,"Boyz n the Hood",1991,56190094,25001,56215095
2477,"Quartet",2012,18388357,37790578,56178935
2478,"Frida",2002,25885000,30246239,56131239
2479,"The 15:17 to Paris",2018,36276286,19819914,56096200
2480,"The Big Chill",1983,56077501,0,56077501
2481,"Eastern Promises",2007,17181265,38895823,56077088
2482,"Spice World",1998,29342592,26700000,56042592
2483,"Da Ren Wu",2019,0,56040680,56040680
2484,"Florence Foster Jenkins",2016,27383770,28616569,56000339
2485,"Silent Hill: Revelation 3D",2012,17530219,38445453,55975672
2486,"Why Did I Get Married?",2007,55204525,729653,55934178
2487,"Cop Out",2010,44875481,11034429,55909910
2488,"Kicking and Screaming",2005,52842724,3000000,55842724
2489,"The Animal",2001,55762229,0,55762229
2490,"In Search of Noah's Ark",1977,55700000,0,55700000
2491,"Pay it Forward",2000,33508922,22187783,55696705
2492,"Pooh's Heffalump Movie",2005,18098433,37588511,55686944
2493,"The Aristocats",1970,55675257,0,55675257
2494,"The Craft",1996,24769466,30900000,55669466
2495,"Definitely, Maybe",2008,32241649,23376217,55617866
2496,"The Beverly Hillbillies",1993,42222647,13375834,55598481
2497,"Wild Things",1998,29795299,25781400,55576699
2498,"The Lizzie McGuire Movie",2003,42734455,12800000,55534455
2499,"Open Water",2004,30500882,25017759,55518641
2500,"Lucky Number Slevin",2006,22495466,33000000,55495466
2501,"Out of Time",2003,41083108,14406718,55489826
2502,"Never Been Kissed",1999,55474757,0,55474757
2503,"Rugrats Go Wild",2003,39402572,16040460,55443032
2504,"Great Expectations",1998,26333044,29073394,55406438
2505,"Zoolander 2",2016,28848693,26500000,55348693
2506,"Police Academy 2: Their First Assignment",1985,55337042,0,55337042
2507,"We Own the Night",2007,28563179,26744678,55307857
2508,"Yi jiu si er",2012,212475,55075212,55287687
2509,"She's the Man",2006,33889159,21390449,55279608
2510,"The Odd Life of Timothy Green",2012,51853450,3395709,55249159
2511,"Extremely Loud and Incredibly Close",2011,31847881,23400000,55247881
2512,"Waking Ned Devine",1998,24793251,30400000,55193251
2513,"The Giver",2014,45090374,10000000,55090374
2514,"Halloween: H2O",1998,55041738,0,55041738
2515,"The Motorcycle Diaries",2004,16756372,38272828,55029200
2516,"Dawn of the Dead",1979,5100000,49900000,55000000
2517,"Analyze That",2002,32122249,22872508,54994757
2518,"All Eyez on Me",2016,44922302,9954553,54876855
2519,"St. Vincent",2014,44137712,10699522,54837234
2520,"Predator 2",1990,28317513,26450905,54768418
2521,"Doc Hollywood",1991,54751779,0,54751779
2522,"Ironiya Sudby. Prodolzhenie",2007,0,54700664,54700664
2523,"Kuai Ba Wo Ge Dai Zou",2018,0,54663066,54663066
2524,"Shi Lian 33 Tian",2011,0,54640000,54640000
2525,"The Hot Chick",2002,35081550,19557959,54639509
2526,"Qin ai de",2014,0,54630000,54630000
2527,"Driven",2001,32616869,22000000,54616869
2528,"National Security",2003,36288951,18310349,54599300
2529,"Looney Tunes: Back in Action",2003,20950820,33589842,54540662
2530,"The Punisher",2004,33664370,20869404,54533774
2531,"Downsizing",2017,24449754,30013217,54462971
2532,"Barbershop: The Next Cut",2016,54030051,374151,54404202
2533,"Lawless",2012,37397291,16996396,54393687
2534,"Spanglish",2004,42044321,12300000,54344321
2535,"No Good Deed",2014,52543632,1779578,54323210
2536,"Varsity Blues",1999,52894169,1400000,54294169
2537,"The Abyss",1989,54243125,0,54243125
2538,"La Bamba",1987,54215416,0,54215416
2539,"Domestic Disturbance",2001,45207112,9000000,54207112
2540,"Madea's Big Happy Family",2011,53345287,815531,54160818
2541,"Sinister 2",2015,27740955,26363270,54104225
2542,"The Three Stooges",2012,44338224,9714025,54052249
2543,"The Borrowers",1998,22619589,31426243,54045832
2544,"Les Visiteurs: La Révolution",2016,0,53999678,53999678
2545,"The Verdict",1982,53977250,0,53977250
2546,"Edward Scissorhands",1990,53976987,0,53976987
2547,"The Big Sick",2017,42872467,11100393,53972860
2548,"Aeon Flux",2005,25857987,28055586,53913573
2549,"Mickey Blue Eyes",1999,33864342,20000000,53864342
2550,"The International",2009,25450527,28400000,53850527
2551,"I, Tonya",2017,30014534,23782875,53797409
2552,"The Messengers",2007,35374833,18400000,53774833
2553,"The Three Musketeers",1993,53661805,0,53661805
2554,"Rookie of the Year",1993,53579269,0,53579269
2555,"Stranger Than Fiction",2006,40435190,13137632,53572822
2556,"Nine",2009,19676965,33831893,53508858
2557,"All the Money in the World",2017,25106325,28350102,53456427
2558,"Bounce",2000,36805288,16620004,53425292
2559,"RoboCop",1987,53424681,0,53424681
2560,"The Boy Next Door",2015,36006065,17395873,53401938
2561,"Eiga Youkai wocchi: Enma daiou to 5-tsu no mono…",2015,0,53396284,53396284
2562,"Throw Momma From the Train",1987,53380796,0,53380796
2563,"An Inconvenient Truth",2006,24146161,29219764,53365925
2564,"Molly’s Game",2017,28780744,24515680,53296424
2565,"Radio",2003,52333738,959890,53293628
2566,"Papillon",1973,53267000,25989,53292989
2567,"A Chinese Odyssey: Part Three",2016,0,53258383,53258383
2568,"Hollywood Adventures",2015,0,53246837,53246837
2569,"Arachnophobia",1990,53208180,0,53208180
2570,"Doubt",2008,33446470,19744631,53191101
2571,"Pitch Black",2000,39235088,13947000,53182088
2572,"Tyler Perry’s Temptation",2013,51975354,1167790,53143144
2573,"From Paris With Love",2010,24077427,29061741,53139168
2574,"That Awkward Moment",2014,26068955,27000000,53068955
2575,"Wickie und die starken Männer",2009,0,53049987,53049987
2576,"Konferenz der Tiere",2010,0,53048539,53048539
2577,"To the Limit",1989,53000000,0,53000000
2578,"The Sinking of Japan",2006,0,53000000,53000000
2579,"Suspect X",2008,0,53000000,53000000
2580,"Defiance",2009,28644813,24342941,52987754
2581,"My Cousin Vinny",1992,52929168,0,52929168
2582,"Message in a Bottle",1999,52880016,0,52880016
2583,"Outrageous Fortune",1987,52864741,0,52864741
2584,"Patriots Day",2016,31886361,20951628,52837989
2585,"Choi-jong-byeong-gi-hwal",2011,40685,52720006,52760691
2586,"American Gigolo",1980,22743674,30000000,52743674
2587,"Untraceable",2008,28687835,23962116,52649951
2588,"Beethoven's 2nd",1993,52636940,0,52636940
2589,"The Roommate",2011,37300107,15245600,52545707
2590,"Tyler Perry's A Madea Christmas",2013,52543354,0,52543354
2591,"Leokki",2016,466505,52024596,52491101
2592,"Big Fat Liar",2002,47811275,4649742,52461017
2593,"Wild",2014,37880356,14580187,52460543
2594,"The Night Before",2015,43035725,9391621,52427346
2595,"Mother’s Day",2016,32492859,19874163,52367022
2596,"Wo de te gong ye ye",2016,0,52352517,52352517
2597,"Le Petit Nicolas",2010,201857,52137709,52339566
2598,"Ordinary People",1980,52302978,0,52302978
2599,"The Color of Money",1986,52293000,0,52293000
2600,"Stand by Me",1986,52287414,0,52287414
2601,"One Hour Photo",2002,31597131,20626175,52223306
2602,"Nowhere to Run",1993,22189039,30000000,52189039
2603,"10",1979,52134699,0,52134699
2604,"Bareilly Ki Barfi",2017,0,52117236,52117236
2605,"The Outlaws",2017,0,52097753,52097753
2606,"Ekipazh",2016,0,52092388,52092388
2607,"South Park: Bigger, Longer & Uncut",1999,52037603,0,52037603
2608,"Amadeus",1984,51973029,0,51973029
2609,"The Age of Shadows",2016,540268,51407834,51948102
2610,"Hanging Up",2000,36037909,15829814,51867723
2611,"Peppermint",2018,35418723,16393677,51812400
2612,"1987: When the Day Comes",2017,0,51774683,51774683
2613,"I Can Do Bad All By Myself",2009,51733921,0,51733921
2614,"Slender Man",2018,30564825,21158819,51723644
2615,"Himalaya",2015,696717,51009970,51706687
2616,"Maximum Risk",1996,14102929,37600000,51702929
2617,"Homefront",2013,20158492,31536870,51695362
2618,"Biloxi Blues",1988,43184798,8500000,51684798
2619,"Awakenings",1990,51636504,0,51636504
2620,"Teen Titans Go! To The Movies",2018,29790236,21830357,51620593
2621,"Blue Crush",2002,40118420,11500000,51618420
2622,"Goksung",2016,786633,50752929,51539562
2623,"Eiga Doraemon: Shin Nobita no Nippon tanjou",2016,0,51509375,51509375
2624,"Daybreakers",2010,30101577,21343926,51445503
2625,"Sneakers",1992,51433000,0,51433000
2626,"Breaking In",2018,46840590,4571030,51411620
2627,"Bei Shang Ni Liu Cheng He",2018,0,51400598,51400598
2628,"Astérix: Le domaine des dieux",2014,1656287,49723183,51379470
2629,"Mortal Kombat: Annihilation",1997,35927406,15400000,51327406
2630,"Hooper",1978,51290536,0,51290536
2631,"Fargo",1996,24567751,26636816,51204567
2632,"Bodyguard",2011,1834384,49285374,51119758
2633,"Silver Streak",1976,51079064,0,51079064
2634,"The Family",2013,36918811,14159730,51078541
2635,"Oh, God!",1977,51061196,0,51061196
2636,"All the President's Men",1976,51048435,0,51048435
2637,"Naked Gun 33 1/3: The Final Insult",1994,51041856,0,51041856
2638,"Las aventuras de Tadeo Jones",2012,0,51029081,51029081
2639,"Master",2016,584298,50423395,51007693
2640,"Enough",2002,39177215,11793445,50970660
2641,"Team America: World Police",2004,32774834,18173977,50948811
2642,"Bull Durham",1988,50888729,0,50888729
2643,"Nine Lives",2016,19700032,31180953,50880985
2644,"College Road Trip",2008,45610425,5263498,50873923
2645,"Yeh Jawaani Hai Deewani",2013,3827466,47000000,50827466
2646,"Coco avant Chanel",2009,6113834,44700000,50813834
2647,"You Got Served",2004,40066497,10745361,50811858
2648,"A Bridge Too Far",1977,50800000,0,50800000
2649,"Song of Youth",2019,0,50780000,50780000
2650,"Gekijouban Pokketo monsutâ Besuto wisshu: Pikut…",2011,0,50776443,50776443
2651,"Feng Bao",2013,0,50770000,50770000
2652,"Hable con ella",2002,9284265,41484015,50768280
2653,"The Mighty Ducks",1992,50752337,0,50752337
2654,"August: Osage County",2013,37738810,13000000,50738810
2655,"Sea Monsters: A Prehistoric Adventure",2007,23746066,26982097,50728163
2656,"Elizabethtown",2005,26850426,23868947,50719373
2657,"Bonnie and Clyde",1967,50700000,0,50700000
2658,"Bride of Chucky",1998,32404188,18288000,50692188
2659,"The Deep",1977,50681884,0,50681884
2660,"Meet Dave",2008,11803254,38845552,50648806
2661,"The Master",2012,16247159,34400257,50647416
2662,"The Crow",1994,50638075,0,50638075
2663,"Mighty Joe Young",1998,50632037,0,50632037
2664,"Notes on a Scandal",2006,17510118,33068293,50578411
2665,"The Love Bug",1969,50576808,0,50576808
2666,"The Texas Chainsaw Massacre: The Beginning",2006,39517763,11000000,50517763
2667,"Eddie Murphy Raw",1987,50504655,0,50504655
2668,"Diary of a Mad Black Woman",2005,50406346,52010,50458356
2669,"About Last Night",2014,48637684,1808176,50445860
2670,"Hollywood Homicide",2003,30207785,20201968,50409753
2671,"Red Tails",2012,49876377,489121,50365498
2672,"Concussion",2015,34531832,15831958,50363790
2673,"Nightcrawler",2014,32381218,17953200,50334418
2674,"K-PAX",2001,50315140,0,50315140
2675,"Natural Born Killers",1994,50282766,0,50282766
2676,"Angels in the Outfield",1994,50236831,0,50236831
2677,"Grindhouse",2007,25031037,25156752,50187789
2678,"Sphere",1998,37068294,13100000,50168294
2679,"Supercondriaque",2014,0,50160446,50160446
2680,"Breakdown",1997,50159144,0,50159144
2681,"Winnie the Pooh",2011,26692846,23452761,50145607
2682,"The Women",2008,26902075,23201733,50103808
2683,"The Longest Day",1962,39100000,11000000,50100000
2684,"Fever Pitch",2005,42071069,8000000,50071069
2685,"Absolute Power",1997,50068310,0,50068310
2686,"The Replacements",2000,44737059,5317452,50054511
2687,"When a Man Loves a Woman",1994,50021959,0,50021959
2688,"The Deer Hunter",1979,50000000,9253,50009253
2689,"A Walk in the Clouds",1995,50008143,0,50008143
2690,"Little Women",1994,50003303,0,50003303
2691,"Reds",1981,50000000,0,50000000
2692,"Raising Helen",2004,37485528,12443152,49928680
2693,"Capote",2005,28750530,21173549,49924079
2694,"The Way We Were",1973,49919870,0,49919870
2695,"The Hurt Locker",2009,17017811,32876412,49894223
2696,"The Switch",2010,27758465,22100000,49858465
2697,"Legal Eagles",1986,49851591,0,49851591
2698,"Popeye",1980,49823037,0,49823037
2699,"Bakemono no ko",2015,490643,49323139,49813782
2700,"Pleasantville",1998,40584421,9221041,49805462
2701,"Leaving Las Vegas",1995,31983777,17816223,49800000
2702,"Major League",1989,49793054,0,49793054
2703,"Planes, Trains & Automobiles",1987,49509935,242306,49752241
2704,"Kokuriko-zaka Kara",2013,1000878,48742934,49743812
2705,"This Christmas",2007,49121934,611611,49733545
2706,"Sky Captain and the World of Tomorrow",2004,37760080,11970774,49730854
2707,"Ip Man: Legend of the Grand Master",2011,205675,49516279,49721954
2708,"La ch'tite famille",2018,0,49690586,49690586
2709,"Drillbit Taylor",2008,32862104,16824159,49686263
2710,"How Do You Know?",2010,30212620,19415557,49628177
2711,"The Ant Bully",2006,28142535,21468363,49610898
2712,"Oliver & Company",1988,49576671,0,49576671
2713,"Surprise: Journey to the West",2015,0,49576645,49576645
2714,"The Fourth Kind",2009,26218170,23268704,49486874
2715,"Dark Water",2005,25473093,24000000,49473093
2716,"Shampoo",1975,49407734,0,49407734
2717,"National Lampoon's European Vacation",1985,49400000,0,49400000
2718,"A Nightmare on Elm Street 4: The Dream Master",1988,49369899,0,49369899
2719,"The Finest Hours",2016,27569558,21683203,49252761
2720,"The Black Dahlia",2006,22672813,26565712,49238525
2721,"Operation Chromite",2016,1022720,48173812,49196532
2722,"The Last King of Scotland",2006,17606684,31548687,49155371
2723,"Hwa-ryeo-han hyuga",2007,0,49136551,49136551
2724,"The Negotiator",1998,44705766,4400000,49105766
2725,"Bugsy",1991,49103967,0,49103967
2726,"Demain Tout Commence",2014,0,49070099,49070099
2727,"Cobra",1986,49042224,0,49042224
2728,"Danny the Dog",2005,24537621,24500000,49037621
2729,"So Young 2: Never Gone",2016,96421,48905977,49002398
2730,"Arthur et la vengeance de Maltazard",2011,347136,48648356,48995492
2731,"Death at a Funeral",2010,42739347,6237886,48977233
2732,"Alpha and Omega 3D",2010,25107267,23851086,48958353
2733,"The Rescuers",1977,48775599,0,48775599
2734,"She's Out of My League",2010,32010860,16670117,48680977
2735,"The Avengers",1998,23385416,25200000,48585416
2736,"Death Wish",2018,34017028,14558937,48575965
2737,"Isn’t it Romantic",2019,48573712,0,48573712
2738,"The Omen",1976,48570885,0,48570885
2739,"Fat Albert",2004,48114556,449000,48563556
2740,"9",2009,31749894,16810105,48559999
2741,"Parker",2013,17616641,30926747,48543388
2742,"Frozen",2010,246177,48286888,48533065
2743,"Les petits mouchoirs",2012,205505,48325382,48530887
2744,"Charlie St. Cloud",2010,31206263,17271821,48478084
2745,"Magnolia",1999,22450975,25995827,48446802
2746,"The Big Wedding",2013,21819348,26606623,48425971
2747,"The Last Stand",2013,12050299,36280458,48330757
2748,"Her",2014,25568251,22690780,48259031
2749,"Malcolm X",1992,48169910,0,48169910
2750,"G.I. Jane",1997,48169156,0,48169156
2751,"Red Dawn",2012,44806783,3357367,48164150
2752,"The Preacher's Wife",1996,48102795,0,48102795
2753,"Tightrope",1984,48100000,0,48100000
2754,"Kong tian liè",2017,0,48069252,48069252
2755,"Scott Pilgrim vs. The World",2010,31611316,16445448,48056764
2756,"Single White Female",1992,48017402,0,48017402
2757,"Welcome to Dongmakgol",2005,0,48000000,48000000
2758,"Sutekina kanashibari",2011,0,47966182,47966182
2759,"Wayne's World 2",1993,47965000,0,47965000
2760,"Sunny",2011,0,47958698,47958698
2761,"The Natural",1984,47951979,0,47951979
2762,"The Blue Lagoon",1980,47923795,0,47923795
2763,"Secondhand Lions",2003,42070939,5831627,47902566
2764,"High Fidelity",2000,27277055,20604608,47881663
2765,"Tyler Perry’s Boo 2! A Madea Halloween",2017,47319572,560000,47879572
2766,"Ji Qi Zhi Xue",2017,0,47872755,47872755
2767,"Trouble with the Curve",2012,35763137,12055776,47818913
2768,"Arthur",2011,33035397,14752546,47787943
2769,"Shutter",2008,25928550,21853876,47782426
2770,"Prem Ratan Dhan Payo",2015,4364639,43400000,47764639
2771,"George A. Romero's Land of the Dead",2005,20700082,27050933,47751015
2772,"Book of Shadows: Blair Witch 2",2000,26421314,21300000,47721314
2773,"Hachiko: A Dog's Story",2010,0,47707417,47707417
2774,"Texas Chainsaw 3D",2013,34341945,13324068,47666013
2775,"New Jack City",1991,47624253,0,47624253
2776,"The World's End",2013,26004851,21503654,47508505
2777,"An American Tail",1986,47483002,0,47483002
2778,"The Rescuers Down Under",1990,27931461,19500000,47431461
2779,"Les Tuche 3",2018,0,47427990,47427990
2780,"Crazy Heart",2009,39471742,7945509,47417251
2781,"Phantom Thread",2017,21198205,26212201,47410406
2782,"Man on the Moon",1999,34580635,12827000,47407635
2783,"Hard To Kill",1990,47381386,141,47381527
2784,"Almost Famous",2000,32522352,14848839,47371191
2785,"Walking Tall",2004,46213824,1100000,47313824
2786,"<U+9577><U+6C5F><U+4E03><U+865F> (CJ7)",2008,206678,47094093,47300771
2787,"Darkness Falls",2003,32539681,14750077,47289758
2788,"Airport 1975",1974,47285152,0,47285152
2789,"The Watcher",2000,28946615,18321214,47267829
2790,"The Hunted",2003,34234008,12979087,47213095
2791,"The Wedding Date",2005,31726995,15448043,47175038
2792,"Soul Surfer",2011,43853424,3305228,47158652
2793,"The Toy",1982,47118057,0,47118057
2794,"Fantastic Mr. Fox",2009,21002919,26080493,47083412
2795,"Meitantei Conan: Chinmoku no kuôtâ",2011,0,47024973,47024973
2796,"Dabangg",2010,1288549,45728469,47017018
2797,"The Place Beyond the Pines",2013,21403519,25607930,47011449
2798,"Desu Noto 2",2009,0,47000000,47000000
2799,"Xiong Chu Mei Zhi Xue Ling Xiong Feng",2015,0,46998773,46998773
2800,"Urban Cowboy",1980,46918287,0,46918287
2801,"See No Evil, Hear No Evil",1989,46900000,0,46900000
2802,"Rough Night",2017,22105643,24738714,46844357
2803,"Chef",2014,31424004,15405305,46829309
2804,"Deck the Halls",2006,35093569,11722238,46815807
2805,"Death at a Funeral",2007,8580428,38210000,46790428
2806,"Goodfellas",1990,46743809,33538,46777347
2807,"The Spy Next Door",2010,24307106,22445752,46752858
2808,"Fortress",1993,6730578,40000000,46730578
2809,"Fletch",1985,46700000,0,46700000
2810,"Get Rich or Die Tryin'",2005,30981850,15685105,46666955
2811,"Dog Day Afternoon",1975,46665856,0,46665856
2812,"Under the Sea 3D",2009,36006061,10638746,46644807
2813,"The Wrestler",2008,26238243,20396032,46634275
2814,"Acrimony",2018,43549096,3078740,46627836
2815,"Colors",1988,46616067,0,46616067
2816,"Look Who's Talking Too",1990,46614448,0,46614448
2817,"The Debt",2011,31177548,15426506,46604054
2818,"Bangkok Dangerous",2008,15298133,31300000,46598133
2819,"Dvizhenie Vverkh",2017,0,46592513,46592513
2820,"The Rocketeer",1991,46573027,0,46573027
2821,"The Brady Bunch Movie",1995,46546167,0,46546167
2822,"Uncle Drew",2018,42469946,4057215,46527161
2823,"The Last House on the Left",2009,32752215,13774028,46526243
2824,"How the West Was Won",1963,46500000,0,46500000
2825,"Entourage",2015,32363404,14075134,46438538
2826,"The Distinguished Gentleman",1992,46434570,0,46434570
2827,"A Monster Calls",2016,3740823,42673707,46414530
2828,"Machete",2010,26593646,19777324,46370970
2829,"The Paper",1994,36768310,9600000,46368310
2830,"The Nativity Story",2006,37629831,8679813,46309644
2831,"Miracle on 34th Street",1994,17195886,29100000,46295886
2832,"Addams Family Values",1993,46293855,0,46293855
2833,"Des Hommes et Des Dieux",2011,3954651,42308874,46263525
2834,"Qi Man Dun Jia",2017,124187,46139046,46263233
2835,"Risen",2016,36880033,9375730,46255763
2836,"The Enforcer",1976,46200000,0,46200000
2837,"The Big Lebowski",1998,17498804,28690764,46189568
2838,"Torque",2004,21176322,25000000,46176322
2839,"One Fine Day",1996,46169663,0,46169663
2840,"Huang Jin Xiong Di",2018,285795,45879283,46165078
2841,"Er Dai Yao Jing",2017,0,46154324,46154324
2842,"Napoleon Dynamite",2004,44540956,1581757,46122713
2843,"Deliverance",1972,46122355,0,46122355
2844,"For Love of the Game",1999,35188640,10924000,46112640
2845,"A Walk to Remember",2002,41227069,4833792,46060861
2846,"Malice",1993,46038636,0,46038636
2847,"The Nanny Diaries",2007,25926673,20064522,45991195
2848,"Mr. Brooks",2007,28476219,17512793,45989012
2849,"The Rainmaker",1997,45916769,0,45916769
2850,"Greystoke: The Legend of Tarzan, Lord of the Apes",1984,45900000,0,45900000
2851,"Black Rain",1989,45892212,0,45892212
2852,"Zan men jie hun ba",2015,461996,45420000,45881996
2853,"The Breakfast Club",1985,45875171,0,45875171
2854,"Gunhamdo",2017,1104957,44767484,45872441
2855,"Mary Queen of Scots",2018,16468499,29403190,45871689
2856,"Brewster's Millions",1985,40800000,5000000,45800000
2857,"Firefox",1982,45785720,0,45785720
2858,"Take Off",2009,0,45743246,45743246
2859,"Gintama",2017,0,45730590,45730590
2860,"McFarland, USA",2015,44480275,1227649,45707924
2861,"Xin Li Zui",2017,0,45698504,45698504
2862,"Man on a Ledge",2012,18620000,27068337,45688337
2863,"RoboCop 2",1990,45681173,0,45681173
2864,"Hot Pursuit",2015,34580201,11091311,45671512
2865,"You yi ge di fang zhi you wo men zhi dao",2015,482013,45160000,45642013
2866,"D2: The Mighty Ducks",1994,45604206,0,45604206
2867,"Dancer in the Dark",2000,4157491,41400000,45557491
2868,"Legend of Tang Dynasty 2",2018,0,45521268,45521268
2869,"Thelma & Louise",1991,45361000,66050,45427050
2870,"Kokowaah",2013,0,45424636,45424636
2871,"Hero",2015,84961,45337587,45422548
2872,"The Life and Times of Grizzly Adams",1974,45411063,0,45411063
2873,"Keeping the Faith",2000,37036404,8300000,45336404
2874,"Wei ai zhi jian ru jia jing",2014,271734,45060000,45331734
2875,"Good Boy!",2003,37667746,7644471,45312217
2876,"The Dirty Dozen",1967,45300000,0,45300000
2877,"Eunmilhage Widaehage",2013,0,45286922,45286922
2878,"Early Man",2018,8267544,37018346,45285890
2879,"Léon",1994,19284974,26000000,45284974
2880,"Deuce Bigalow: European Gigolo",2005,22400154,22873310,45273464
2881,"Cold War",2012,0,45249153,45249153
2882,"Flatliners",2017,16883115,28290623,45173738
2883,"The Duchess",2008,13848978,31311132,45160110
2884,"The Dead End",2015,0,45110000,45110000
2885,"Eddie the Eagle",2016,15789389,29271091,45060480
2886,"Brothers",2009,28544157,16499713,45043870
2887,"Full Metal Jacket",1987,45015999,0,45015999
2888,"The Woman in Black 2: Angel of Death",2015,26501323,18505369,45006692
2889,"Convoy",1978,45000000,0,45000000
2890,"Deep Throat",1972,45000000,0,45000000
2891,"Wind River",2017,33800859,11197393,44998252
2892,"Notorious",2009,36843682,8128501,44972183
2893,"Medicine Man",1992,44948240,0,44948240
2894,"Scarface",1983,44942821,0,44942821
2895,"Boonie Bears III",2016,0,44923271,44923271
2896,"Lakeview Terrace",2008,39263506,5557793,44821299
2897,"A Nightmare On Elm Street 3: Dream Warriors",1987,44793222,0,44793222
2898,"Home",2009,15433,44777735,44793168
2899,"Midnight Cowboy",1969,44785053,0,44785053
2900,"The Shining",1980,44017374,710853,44728227
2901,"Young Guns",1988,44726644,0,44726644
2902,"Jeremiah Johnson",1972,44693786,0,44693786
2903,"Neuk-dae-so-nyeon",2012,342922,44342248,44685170
2904,"Magnum Force",1973,44680473,0,44680473
2905,"Meet Joe Black",1998,44650003,0,44650003
2906,"The Gift",2000,12008642,32558964,44567606
2907,"Ra. One",2011,2509150,42039971,44549121
2908,"The Odd Couple",1968,44527234,0,44527234
2909,"One Missed Call",2008,26890041,17623425,44513466
2910,"The Good Son",1993,44456478,0,44456478
2911,"Recess: School's Out",2001,36696761,7754709,44451470
2912,"Valley of the Dolls",1967,44432255,0,44432255
2913,"Push",2009,31811527,12600000,44411527
2914,"Bereurlin",2013,0,44403920,44403920
2915,"Clash of the Titans",1981,30000000,14400000,44400000
2916,"Winchester",2018,25091816,19286224,44378040
2917,"The Jungle Book",1994,44342956,0,44342956
2918,"The Sisterhood of the Traveling Pants 2",2008,44089964,180167,44270131
2919,"Logan Lucky",2017,27778642,16485629,44264271
2920,"The Postman Always Rings Twice",1981,12200000,32000000,44200000
2921,"Child's Play",1988,33244684,10952000,44196684
2922,"Shi Yue Wei Cheng",2011,0,44195779,44195779
2923,"Young Guns II",1990,44143410,0,44143410
2924,"Oculus",2014,27695246,16420250,44115496
2925,"House at the End of the Street",2012,31611916,12492066,44103982
2926,"Namiya Zakkaten no Kiseki",2017,0,44083821,44083821
2927,"The Boy in the Striped Pyjamas",2008,9046156,35037247,44083403
2928,"Passenger 57",1992,44065653,0,44065653
2929,"The Last Emperor",1987,43984987,20086,44005073
2930,"Semi-Pro",2008,33479698,10500665,43980363
2931,"Exorcist: The Beginning",2004,41814863,2142678,43957541
2932,"Dogma",1999,30651422,13297443,43948865
2933,"The Transporter",2002,25296447,18632485,43928932
2934,"Crank",2006,27838408,16086515,43924923
2935,"Okami Kodomo no Ame to Yuki",2012,0,43909923,43909923
2936,"Love at First Bite",1979,43900000,0,43900000
2937,"The Fox and the Hound",1981,43899231,0,43899231
2938,"Jìyì dàshi",2017,587470,43301061,43888531
2939,"Wall Street",1987,43848100,0,43848100
2940,"A Man Apart",2003,26500000,17297731,43797731
2941,"When in Rome",2010,32680633,11116304,43796937
2942,"Café Society",2016,11103205,32684994,43788199
2943,"Monster's Ball",2001,31273922,12492541,43766463
2944,"Hardball",2001,40222729,3505831,43728560
2945,"West Side Story",1961,43700000,0,43700000
2946,"Max",2015,42656255,1001902,43658157
2947,"Freedom Writers",2007,36605602,7027007,43632609
2948,"Welcome Home Roscoe Jenkins",2008,42436517,1171110,43607627
2949,"Going the Distance",2010,17804299,25799691,43603990
2950,"Police Academy 3: Back in Training",1986,43579163,0,43579163
2951,"We Are Marshall",2006,43545364,0,43545364
2952,"Fly Me To the Moon",2008,14543943,28986338,43530281
2953,"The DUFF",2015,34030343,9498291,43528634
2954,"Soul Food",1997,43492389,0,43492389
2955,"City Slickers II: The Legend of Curly's Gold",1994,43440947,0,43440947
2956,"Pride and Glory",2008,15740721,27700000,43440721
2957,"A River Runs Through It",1992,43440294,0,43440294
2958,"Feng Shen Bang",2016,143430,43272557,43415987
2959,"Jobs",2013,16131410,27271105,43402515
2960,"Harold & Kumar Escape from Guantanamo Bay",2008,38108728,5244389,43353117
2961,"Sur la piste du Marsupilami",2012,0,43343964,43343964
2962,"Last Holiday",2006,38399961,4943286,43343247
2963,"Orange County",2002,41059716,2248991,43308707
2964,"Girl with a Pearl Earring",2003,11634362,31640435,43274797
2965,"The Snowman",2017,6670765,36555381,43226146
2966,"Marked for Death",1990,43224499,0,43224499
2967,"Midway",1976,43220000,0,43220000
2968,"Boogie Nights",1997,26410771,16700954,43111725
2969,"Annihilation",2018,32732301,10338614,43070915
2970,"See Spot Run",2001,33357476,9700076,43057552
2971,"Tom yum goong",2006,12044087,31000000,43044087
2972,"The Longest Yard",1974,43008075,0,43008075
2973,"Regarding Henry",1991,43001500,0,43001500
2974,"Meatballs",1979,43000000,0,43000000
2975,"Escape from Alcatraz",1979,43000000,0,43000000
2976,"California Suite",1978,42913571,0,42913571
2977,"No Escape",2015,27288872,15555644,42844516
2978,"Carol",2015,12711491,30132030,42843521
2979,"Glory Road",2006,42647449,151611,42799060
2980,"Just Friends",2005,32596916,10200763,42797679
2981,"The Possession of Hannah Grace",2018,14836174,27949213,42785387
2982,"The Uninvited",2009,28596818,14182143,42778961
2983,"Shaolin Soccer",2004,488872,42287160,42776032
2984,"Hindi Medium",2017,0,42732776,42732776
2985,"Heartbreak Ridge",1986,42724017,0,42724017
2986,"The Electric Horseman",1979,42670138,0,42670138
2987,"Basic",2003,26599248,15999250,42598498
2988,"Pokemon 2008",2008,0,42563360,42563360
2989,"mother!",2017,17800004,24731072,42531076
2990,"Almost Christmas",2016,42065185,428321,42493506
2991,"The Four Seasons",1981,42488161,0,42488161
2992,"Robinson Crusoe",2016,8005586,34440869,42446455
2993,"To Sir With Love",1967,42432803,0,42432803
2994,"Legend",2015,1872994,40552456,42425450
2995,"Mask",1985,42417782,0,42417782
2996,"Chernobyl Diaries",2012,18119640,24292081,42411721
2997,"Forever Young",2015,149761,42237010,42386771
2998,"8 femmes",2002,3076425,39300000,42376425
2999,"My Name is Khan",2010,4046336,38309190,42355526
3000,"The Bad News Bears",1976,42349782,0,42349782
3001,"Blue Thunder",1983,42313354,0,42313354
3002,"Bullitt",1968,42300873,0,42300873
3003,"Chu zi Xi zi Pi zi",2013,0,42280000,42280000
3004,"Teenage Mutant Ninja Turtles III",1993,42273609,0,42273609
3005,"Jaws 3-D",1983,42245180,0,42245180
3006,"Love the Coopers",2015,26302731,15924759,42227490
3007,"Joheunnom nabbeunnom isanghannom",2010,128486,42098171,42226657
3008,"Bad Genius",2017,0,42197645,42197645
3009,"21 and Over",2013,25682380,16513386,42195766
3010,"Earth to Echo",2014,38934842,3239703,42174545
3011,"Dabangg 2",2012,2474674,39690424,42165098
3012,"White Nights",1985,42160849,0,42160849
3013,"In the Bedroom",2001,35930604,6207267,42137871
3014,"Loving Vincent",2017,6735118,35374780,42109898
3015,"T2: Trainspotting",2017,2402004,39689258,42091262
3016,"A Good Year",2006,7459300,34604805,42064105
3017,"Dirty Rotten Scoundrels",1988,42039000,0,42039000
3018,"Gamer",2009,20534907,21467122,42002029
3019,"Bagdad Cafe",1988,3587303,38414607,42001910
3020,"Around the World in 80 Days",1956,42000000,0,42000000
3021,"Into the Blue",2005,18782227,23200000,41982227
3022,"Meet the Browns",2008,41975388,0,41975388
3023,"Meari to majo no hana",2017,2418404,39543806,41962210
3024,"Taxi 5",2018,0,41957523,41957523
3025,"Papita 2da Base",2017,0,41950000,41950000
3026,"Holmes & Watson",2018,30568743,11357862,41926605
3027,"Quarantine",2008,31691811,10232963,41924774
3028,"A Lot Like Love",2005,21835784,20085806,41921590
3029,"Meitantei Conan: Juichi-ninme no Striker",2012,0,41863105,41863105
3030,"The Return of the Pink Panther",1975,41833347,0,41833347
3031,"Homeward Bound: The Incredible Journey",1993,41833324,0,41833324
3032,"As Above, So Below",2014,21222315,20601751,41824066
3033,"Eiga Doraemon: Nobita no Getsumen Tansaki",2019,0,41814288,41814288
3034,"The Fisher King",1991,41798224,0,41798224
3035,"Balls of Fury",2007,32886940,8893086,41780026
3036,"The Informant!",2009,33316821,8454347,41771168
3037,"Ansisung",2018,472166,41282567,41754733
3038,"Casino Royale",1967,22744718,19000000,41744718
3039,"Easy Rider",1969,41728598,0,41728598
3040,"Still Alice",2015,18656400,23043212,41699612
3041,"Sado",2015,0,41695667,41695667
3042,"Cheech & Chong's Next Movie",1980,41675194,0,41675194
3043,"Wimbledon",2004,16862585,24803891,41666476
3044,"Di Qiu Zui Hou De Ye Wang",2018,129888,41526989,41656877
3045,"The Gallows",2015,22764410,18892064,41656474
3046,"Dream House",2011,21302340,20339826,41642166
3047,"Astro Boy",2009,19551067,22085176,41636243
3048,"Call Me by Your Name",2017,18065180,23552537,41617717
3049,"Up in Smoke",1978,41590893,0,41590893
3050,"The Sisterhood of the Traveling Pants",2005,39053061,2507056,41560117
3051,"Meitantei Conan: Chinmoku No 15 Fun",2011,0,41545553,41545553
3052,"The Lady in the Van",2015,10021175,31495270,41516445
3053,"Three Days of the Condor",1975,41509797,0,41509797
3054,"Safe",2012,17142080,24353133,41495213
3055,"Gremlins 2: The New Batch",1990,41476097,0,41476097
3056,"Dredd",2012,13414714,28052892,41467606
3057,"Gridiron Gang",2006,38432823,3025011,41457834
3058,"The Great Outdoors",1988,41455230,0,41455230
3059,"Ghajini",2008,2430631,39000000,41430631
3060,"Pale Rider",1985,41410568,0,41410568
3061,"Peggy Sue Got Married",1986,41382841,0,41382841
3062,"Leatherheads",2008,31373938,9974690,41348628
3063,"Man of the Year",2006,37442180,3900000,41342180
3064,"50/50",2011,35016118,6318617,41334735
3065,"Cabaret",1972,41326446,0,41326446
3066,"Gosford Park",2001,41300105,0,41300105
3067,"This is Where I Leave You",2014,34296320,7000000,41296320
3068,"The Guilt Trip",2012,37134215,4160459,41294674
3069,"Don Jon",2013,24477704,16790875,41268579
3070,"The Mirror Has Two Faces",1996,41267469,0,41267469
3071,"Private Parts",1997,41198146,0,41198146
3072,"Luftslottet som sprängdes",2010,5427684,35751976,41179660
3073,"Ricki and the Flash",2015,26839498,14326535,41166033
3074,"The French Connection",1971,41158757,0,41158757
3075,"Money Talks",1997,41076865,0,41076865
3076,"The Best of Me",2014,26766213,14293205,41059418
3077,"Zhao Dao Ni",2018,0,41046927,41046927
3078,"Drive Angry",2011,10721033,30321550,41042583
3079,"Happy Gilmore",1996,38623460,2380952,41004412
3080,"2010",1984,41000000,0,41000000
3081,"Poltergeist II: The Other Side",1986,40996665,0,40996665
3082,"30 Minutes or Less",2011,37053924,3912792,40966716
3083,"Pokemon 2009",2009,0,40952392,40952392
3084,"Pee Wee's Big Adventure",1985,40940662,0,40940662
3085,"Falling Down",1993,40903593,0,40903593
3086,"Revenge of the Nerds",1984,40874452,0,40874452
3087,"Where the Heart Is",2000,33771174,7090880,40862054
3088,"Undercover Brother",2002,38230435,2565710,40796145
3089,"The Forest",2016,26594261,14154969,40749230
3090,"Broken Flowers",2005,13744960,27000000,40744960
3091,"Short Circuit",1986,40697761,0,40697761
3092,"War",2007,22486409,18200000,40686409
3093,"The Circle",2017,20497844,20154020,40651864
3094,"Sin City: A Dame to Kill For",2014,13757804,26893038,40650842
3095,"Three Fugitives",1989,40590000,0,40590000
3096,"The Dark Crystal",1982,40577001,0,40577001
3097,"El secreto de sus ojos",2010,6391436,34136283,40527719
3098,"Fright Night",2011,18298649,22222000,40520649
3099,"Jagged Edge",1985,40491165,0,40491165
3100,"Bill & Ted's Excellent Adventure",1989,40485039,0,40485039
3101,"Pretty in Pink",1986,40471663,0,40471663
3102,"The Witch",2016,25138705,15315815,40454520
3103,"The Ringer",2005,35428675,5013762,40442437
3104,"Bless the Child",2000,29374178,11061516,40435694
3105,"Foul Play",1978,40415179,0,40415179
3106,"Swiss Family Robinson",1960,40400000,0,40400000
3107,"The Master of Disguise",2002,40363530,0,40363530
3108,"Serenity",2005,25514517,14804923,40319440
3109,"La mala educación",2004,5211842,35100000,40311842
3110,"Fist Fight",2017,32187017,8099399,40286416
3111,"The Faculty",1998,40283321,0,40283321
3112,"Mo' Money",1992,40190000,0,40190000
3113,"The Piano",1993,40157856,11101,40168957
3114,"The Love Guru",2008,32235793,7923224,40159017
3115,"Big Business",1988,40150487,0,40150487
3116,"The Invasion",2007,15074191,25072851,40147042
3117,"All About Steve",2009,33862903,6264356,40127259
3118,"Twisted",2004,25195050,14924798,40119848
3119,"Scoop",2006,10525717,29577545,40103262
3120,"Encounter in the Third Dimension",1999,7195792,32906421,40102213
3121,"Grand Canyon",1991,32350000,7748309,40098309
3122,"N.L.L: Yeonpyeong Haejeon",2015,324719,39769627,40094346
3123,"Hannah and Her Sisters",1986,40084041,0,40084041
3124,"Encino Man",1992,40057130,0,40057130
3125,"Funny Lady",1975,40055897,0,40055897
3126,"The King",2017,0,40045465,40045465
3127,"Love O2O",2016,0,40029536,40029536
3128,"Man of the House",1995,40029009,0,40029009
3129,"I Still Know What You Did Last Summer",1998,40020622,0,40020622
3130,"Thank You For Smoking",2006,24793509,15223153,40016662
3131,"The Secret Life of Bees",2008,37780486,2213861,39994347
3132,"xiu chun dao II: xiu luo zhan chang",2017,14204,39951588,39965792
3133,"Manhattan",1979,39946780,17736,39964516
3134,"Magnificent Desolation",2005,34126126,5720770,39846896
3135,"Caddyshack",1980,39846344,0,39846344
3136,"The Beach",2000,39778599,0,39778599
3137,"Cirque du Freak: The Vampire's Assistant",2009,14046595,25707362,39753957
3138,"Pokemon 2007: Diamond & Pearl",2007,0,39739776,39739776
3139,"Cheongnyeon Gyeongchal",2017,0,39737402,39737402
3140,"Memento",2001,25544867,14178229,39723096
3141,"Tequila Sunrise",1988,39703427,0,39703427
3142,"Monte Carlo",2011,23186769,16500000,39686769
3143,"Mar adentro",2004,2086345,37600000,39686345
3144,"Out for Justice",1991,39673161,0,39673161
3145,"Dhoom 2",2006,2643586,37000000,39643586
3146,"Mars Needs Moms",2011,21392758,18157000,39549758
3147,"wanbyeokhan tain",2018,0,39504707,39504707
3148,"Dreamer: Inspired by a True Story",2005,33022286,6476074,39498360
3149,"Overheard 2",2011,0,39479263,39479263
3150,"Nobody's Fool",1994,39453238,0,39453238
3151,"Ocho apellidos catalanes",2015,0,39440104,39440104
3152,"Masukarêdo hoteru",2019,0,39395312,39395312
3153,"Crocodile Dundee in Los Angeles",2001,25590119,13802992,39393111
3154,"Joe Versus the Volcano",1990,39381963,0,39381963
3155,"Becoming Jane",2007,18663911,20716965,39380876
3156,"Whale Rider",2003,20779666,18594934,39374600
3157,"Hocus Pocus",1993,39360491,0,39360491
3158,"Dokjeon",2018,365639,38986708,39352347
3159,"Blade Runner",1982,32656328,6686584,39342912
3160,"Furry Vengeance",2010,17630465,21709712,39340177
3161,"Blind Date",1987,39321000,0,39321000
3162,"Never Back Down",2008,24850922,14468879,39319801
3163,"Partners: The Movie",2008,0,39314819,39314819
3164,"The Last Princess",2016,25753,39232855,39258608
3165,"Anna and the King",1999,39251128,0,39251128
3166,"Three Amigos",1986,39246734,0,39246734
3167,"National Lampoon’s Van Wilder",2002,21305259,17936064,39241323
3168,"Killing Them Softly",2012,14945541,24292902,39238443
3169,"The Legend of Bagger Vance",2000,30695227,8540259,39235486
3170,"Brooklyn's Finest",2010,27163593,12069640,39233233
3171,"Million Dollar Arm",2014,36447959,2769953,39217912
3172,"Minha Mãe é uma Peça 2: O Filme",2016,0,39195564,39195564
3173,"Overlord",2018,21704844,17473345,39178189
3174,"Roxanne",1987,39148164,0,39148164
3175,"Winged Migration",2003,11689053,27445930,39134983
3176,"Don't Be Afraid of the Dark",2011,24046682,15079745,39126427
3177,"Sherlock: The Abominable Bride",2016,0,39111922,39111922
3178,"What's Love Got to Do With It",1993,39100956,0,39100956
3179,"Primary Colors",1998,39017984,0,39017984
3180,"Yentl",1983,39012241,0,39012241
3181,"The Spirit",2008,19806188,19200000,39006188
3182,"The Eagle",2011,19490041,19503507,38993548
3183,"Agora",2010,619423,38372869,38992292
3184,"Blair Witch",2016,20777061,18208516,38985577
3185,"Whiplash",2014,13092006,25877031,38969037
3186,"3 Days to Kill",2014,30697999,8261901,38959900
3187,"Romeo and Juliet (1968)",1968,38901218,6429,38907647
3188,"Red Dawn",1984,38900000,0,38900000
3189,"Tau ming chong",2010,129078,38770714,38899792
3190,"Dnevnoy dozor",2007,459095,38411815,38870910
3191,"K-9",1989,38859189,0,38859189
3192,"Doragon Boru Zetto Kami to Kami",2013,0,38848780,38848780
3193,"The Karate Kid, Part III",1989,38793278,0,38793278
3194,"Clockstoppers",2002,36985501,1803327,38788828
3195,"Criminal",2015,14708696,24062566,38771262
3196,"The Sitter",2011,30542576,8206828,38749404
3197,"Little Shop of Horrors",1986,38747385,0,38747385
3198,"Redi",2011,934951,37799675,38734626
3199,"The Gambler",2014,33680992,5037039,38718031
3200,"About Last Night...",1986,38702310,0,38702310
3201,"Someone Like You",2001,27338033,11346873,38684906
3202,"On Deadly Ground",1994,38590458,0,38590458
3203,"Admiral",2008,0,38585047,38585047
3204,"Urban Legends: Final Cut",2000,21468807,17105555,38574362
3205,"The Ghost and the Darkness",1996,38564422,0,38564422
3206,"The Soloist",2009,31853584,6668866,38522450
3207,"Halloween 2",2009,33392973,5119877,38512850
3208,"Ting Feng Zhe",2012,0,38503726,38503726
3209,"Running Scared",1986,38500726,0,38500726
3210,"A Ga ssi",2016,2006788,36489932,38496720
3211,"Andhadhun",2018,1193049,37276369,38469418
3212,"What's the Worst That Could Happen?",2001,32267774,6194297,38462071
3213,"Crouching Tiger, Hidden Dragon: Sword of Destiny",2016,0,38452981,38452981
3214,"Bachelor Party",1984,38435947,0,38435947
3215,"Fighting With My Family",2019,22814106,15600000,38414106
3216,"Nada a Perder",2018,679531,37720311,38399842
3217,"Bang Bang",2014,2581138,35800000,38381138
3218,"Employee of the Month",2006,28444855,9920000,38364855
3219,"The Darkest Minds",2018,12695691,25665737,38361428
3220,"The Lazarus Effect",2015,25801570,12557740,38359310
3221,"Ex Machina",2015,25440971,12917421,38358392
3222,"Beauty Shop",2004,36351350,2000000,38351350
3223,"City Heat",1984,38348988,0,38348988
3224,"After the Sunset",2004,28328132,10000982,38329114
3225,"Accepted",2006,36580083,1734720,38314803
3226,"Head of State",2003,37788228,495537,38283765
3227,"The Missing",2003,26900336,11353097,38253433
3228,"Annie Hall",1977,38251425,0,38251425
3229,"The Original Kings of Comedy",2000,38168022,68316,38236338
3230,"The In-Laws",1979,38200000,0,38200000
3231,"Starting Over",1979,38200000,0,38200000
3232,"Gongjak",2018,497755,37694206,38191961
3233,"Quest for Camelot",1998,22772500,15400000,38172500
3234,"The Covenant",2006,23364784,14800000,38164784
3235,"Just My Luck",2006,17326650,20833255,38159905
3236,"Jumping the Broom",2011,37295394,863207,38158601
3237,"The Running Man",1987,38122000,0,38122000
3238,"Spaceballs",1987,38119483,0,38119483
3239,"First Sunday",2008,37931869,181539,38113408
3240,"Carnage",2011,2546747,35565407,38112154
3241,"Ri¢hie Ri¢h",1994,38087756,0,38087756
3242,"The Banger Sisters",2002,30306281,7760937,38067218
3243,"Beastly",2011,27865571,10162659,38028230
3244,"Higher Learning",1995,38023585,0,38023585
3245,"Mannequin",1987,38018000,0,38018000
3246,"For Colored Girls",2010,37729698,288175,38017873
3247,"Dead Again",1991,38016380,0,38016380
3248,"Bayside Shakedown 3: Set the Guys Loose",2010,0,38000000,38000000
3249,"Postcards from the Edge",1990,37963281,0,37963281
3250,"Sgt. Bilko",1996,30356589,7600000,37956589
3251,"Happily N'Ever After",2007,15849032,22074786,37923818
3252,"The Dead Pool",1988,37903000,0,37903000
3253,"Mission Milano",2016,0,37834435,37834435
3254,"Emma",1996,22231658,15600000,37831658
3255,"All That Jazz",1979,37823676,0,37823676
3256,"St. Elmo’s Fire",1985,37800000,0,37800000
3257,"The Black Stallion",1979,37799643,0,37799643
3258,"Mighty Morphin Power Rangers: The Movie",1995,37785198,0,37785198
3259,"It Could Happen To You",1994,37784369,0,37784369
3260,"Geomeun Sajedeul",2015,0,37784368,37784368
3261,"Showgirls",1995,20350754,17400000,37750754
3262,"Om Shanti Om",2007,3597372,34145702,37743074
3263,"The Wicker Man",2006,24413467,13308360,37721827
3264,"How Stella Got Her Groove Back",1998,37672944,0,37672944
3265,"Halloween: Resurrection",2002,30259652,7400000,37659652
3266,"Beverly Hills Ninja",1997,31245344,6393685,37639029
3267,"Tom Jones",1963,37600000,0,37600000
3268,"The Fly",1986,37585000,0,37585000
3269,"Hell or High Water",2016,27007844,10576460,37584304
3270,"Bill & Ted's Bogus Journey",1991,37537675,0,37537675
3271,"Pan Zi Xinh Dong Dui",2018,0,37516290,37516290
3272,"The Money Pit",1986,37499651,0,37499651
3273,"The Doctor",1991,37497480,0,37497480
3274,"The Boat That Rocked",2009,8017467,29455184,37472651
3275,"The Hills Have Eyes II",2007,20804166,16662372,37466538
3276,"On the Basis of Sex",2018,24622687,12787457,37410144
3277,"Oliver!",1968,37402877,0,37402877
3278,"Time Bandits",1981,37400000,0,37400000
3279,"Gomorra",2009,1579146,35760448,37339594
3280,"Revenge of the Pink Panther",1978,37337746,0,37337746
3281,"Home Again",2017,27020284,10316590,37336874
3282,"The Majestic",2001,27796042,9510292,37306334
3283,"Psycho",1998,21541218,15685000,37226218
3284,"The Main Event",1979,37198813,0,37198813
3285,"Semi-Tough",1977,37187139,0,37187139
3286,"Brubaker",1980,37121708,0,37121708
3287,"A Walk in the Woods",2015,29499394,7619964,37119358
3288,"The Family That Preys",2008,37105289,0,37105289
3289,"Uptown Girls",2003,37095657,0,37095657
3290,"Women Who Flirt",2014,374116,36720000,37094116
3291,"Jersey Girl",2004,25266129,11800000,37066129
3292,"The Fog",2005,29511112,7537414,37048526
3293,"Nan Ji Jue Lian",2018,118352,36895078,37013430
3294,"Yi Sheng Yi Shi",2014,417558,36590000,37007558
3295,"Cheech & Chong's Nice Dreams",1981,37000000,0,37000000
3296,"Gekijoban Poketto Monsuta Adobansu Jenereshon M…",2005,0,37000000,37000000
3297,"Gifted",2017,24801212,12163444,36964656
3298,"La vérité si je mens! 3",2012,0,36960781,36960781
3299,"The Bachelor",1999,21731001,15151377,36882378
3300,"Zack and Miri Make a Porno",2008,31457946,5398360,36856306
3301,"Just Cause",1995,36853222,0,36853222
3302,"My Favorite Martian",1999,36850101,0,36850101
3303,"Chimpanzee",2012,28965459,7869364,36834823
3304,"Kiss of the Dragon",2001,36833473,0,36833473
3305,"South Pacific",1958,36800000,17550,36817550
3306,"The Adventurers",2017,216556,36585148,36801704
3307,"Amour",2012,6738954,30048090,36787044
3308,"Natale in Crociera",2007,0,36773534,36773534
3309,"Burnt",2015,13651946,23121564,36773510
3310,"Barfi",2012,2804874,33947110,36751984
3311,"Titan A.E.",2000,22751979,14000000,36751979
3312,"Sex, Lies, and Videotape",1989,24741667,12000000,36741667
3313,"The Getaway",1972,36734619,0,36734619
3314,"Qian Ren 2:Bei Tai Fan Ji Zhan",2015,0,36723790,36723790
3315,"Eight Legged Freaks",2002,17266505,19455806,36722311
3316,"Disaster Movie",2008,14190901,22529851,36720752
3317,"The Sword and the Sorcerer",1982,36714025,0,36714025
3318,"Friday the 13th Part 3",1982,36690067,0,36690067
3319,"The Adventures of Pinocchio",1996,15382170,21300000,36682170
3320,"Shine",1996,35811509,860984,36672493
3321,"Best Friends",1982,36670556,0,36670556
3322,"Gung Ho",1986,36611610,0,36611610
3323,"Jackie",2016,13960394,22628118,36588512
3324,"Tarzan, The Ape Man",1981,36565000,0,36565000
3325,"Sicko",2007,24538513,11997324,36535837
3326,"Hotel Rwanda",2004,23519128,13002095,36521223
3327,"Carlito's Way",1993,36516012,0,36516012
3328,"Soapdish",1991,36489888,0,36489888
3329,"Vegas Vacation",1997,36470465,0,36470465
3330,"Fly Away Home",1996,25143818,11325504,36469322
3331,"Born to be Wild 3D",2011,25798735,10669297,36468032
3332,"To Wong Foo Thanks for Everything, Julie Newmar",1995,36466570,0,36466570
3333,"Gamshijadeul",2013,0,36431468,36431468
3334,"Sumbakokjil",2013,0,36412217,36412217
3335,"The Glimmer Man",1996,20404841,16000000,36404841
3336,"Haywire",2012,18942396,17432304,36374700
3337,"Raid Dingue",2017,0,36360000,36360000
3338,"Universal Soldier",1992,36299898,0,36299898
3339,"Alive",1993,36299670,0,36299670
3340,"The Kids Are All Right",2010,20811365,15464104,36275469
3341,"A Very Harold & Kumar 3D Christmas",2011,35061031,1204714,36265745
3342,"Room",2015,14677674,21585109,36262783
3343,"Rumble in the Bronx",1996,32281907,3956845,36238752
3344,"Mad Max Beyond Thunderdome",1985,36230219,0,36230219
3345,"Across The Sea of Time",1995,16015639,20200534,36216173
3346,"Casanova",2005,11304403,24900000,36204403
3347,"One for the Money",2012,26414527,9782694,36197221
3348,"Nobunaga Concerto: The Movie",2016,0,36187592,36187592
3349,"Arthur and the War of Two Worlds",2015,347136,35833688,36180824
3350,"Devil's Due",2014,15821461,20324626,36146087
3351,"Silent Movie",1976,36145695,0,36145695
3352,"Last Tango in Paris",1972,36144824,0,36144824
3353,"Love Happens",2009,22965110,13167904,36133014
3354,"Always 3 Chome no yuhi '64 3",2012,0,36119625,36119625
3355,"T-34",2018,0,36115024,36115024
3356,"Breakin'",1984,36100000,0,36100000
3357,"A Most Wanted Man",2014,17237855,18831035,36068890
3358,"Set It Off",1996,36049108,0,36049108
3359,"Assault On Precinct 13",2005,20040895,16000000,36040895
3360,"Så som i himmelen",2008,10236,36022358,36032594
3361,"Garden State",2004,26782316,9246486,36028802
3362,"The Greatest Show on Earth",1952,36000000,0,36000000
3363,"The Robe",1953,36000000,0,36000000
3364,"Pete’s Dragon",1977,36000000,0,36000000
3365,"The Born Losers",1967,36000000,0,36000000
3366,"Nana",2005,0,36000000,36000000
3367,"What a Girl Wants",2003,35990505,0,35990505
3368,"Miss Potter",2006,3005605,32885652,35891257
3369,"Show Dogs",2018,17744685,18126346,35871031
3370,"Wu ji",2006,669625,35200309,35869934
3371,"Toy Story 3D Double Feature",2009,30702446,5165623,35868069
3372,"Taps",1981,35856053,0,35856053
3373,"Le Grand Bain",2018,0,35844587,35844587
3374,"The Black Hole",1979,35841901,0,35841901
3375,"Kimi no Suizo wo Tabetai",2017,0,35840900,35840900
3376,"Arbitrage",2012,7919574,27911139,35830713
3377,"My Dog Skip",2000,34099640,1695679,35795319
3378,"Faster",2010,23240020,12552925,35792945
3379,"Murder on the Orient Express",1974,35733867,21383,35755250
3380,"The China Syndrome",1979,35708042,0,35708042
3381,"Robin Hood: Men in Tights",1993,35699287,0,35699287
3382,"Other People's Money",1991,35682000,0,35682000
3383,"Father's Day",1997,28681080,7000000,35681080
3384,"Absolutely Fabulous: The Movie",2016,4772155,30900000,35672155
3385,"The Indian in the Cupboard",1995,35627222,0,35627222
3386,"Silkwood",1983,35615609,0,35615609
3387,"Diary of a Wimpy Kid: The Long Haul",2017,20738724,14870853,35609577
3388,"Tyler Perry's Good Deeds",2012,35025791,553386,35579177
3389,"Steve Jobs",2015,17766658,17812349,35579007
3390,"No Way Out",1987,35509515,0,35509515
3391,"Hostiles",2017,29819114,5662827,35481941
3392,"Crank 2: High Voltage",2009,13684249,21788490,35472739
3393,"Down with Love",2003,20305251,15151698,35456949
3394,"Selena",1997,35450113,0,35450113
3395,"Alex Cross",2012,25888412,9538347,35426759
3396,"Basic Instinct 2",2006,5946136,29471026,35417162
3397,"Eye in the Sky",2016,18704596,16698206,35402802
3398,"The Gauntlet",1977,35400000,0,35400000
3399,"The `Burbs",1989,35382246,0,35382246
3400,"Snowden",2015,21587519,13793399,35380918
3401,"A Goofy Movie",1995,35336439,0,35336439
3402,"Namiya",2017,39584,35288134,35327718
3403,"EDtv",1999,22508689,12811000,35319689
3404,"All of Me",1984,35243581,0,35243581
3405,"Les Tuche 2 - Le rêve américain",2016,0,35210425,35210425
3406,"Honeymoon in Vegas",1992,35208854,0,35208854
3407,"Alfie",2004,13395939,21800000,35195939
3408,"Courageous",2011,34522221,663663,35185884
3409,"Mermaids",1990,35140500,0,35140500
3410,"The Adventures of Rocky & Bullwinkle",2000,26000610,9129000,35129610
3411,"Die Welle",2011,0,35122948,35122948
3412,"Summer School",1987,35114428,0,35114428
3413,"Dragon: The Bruce Lee Story",1993,35112679,0,35112679
3414,"Whatever Works",2009,5306706,29800000,35106706
3415,"Destiny: Kamakura Monogatari",2017,0,35099354,35099354
3416,"The Darjeeling Limited",2007,11902715,23174856,35077571
3417,"Commando",1985,35073978,0,35073978
3418,"The Hate U Give",2018,29719483,5348182,35067665
3419,"Shaolin",2011,66099,35000000,35066099
3420,"Xin Li Zui Zhi Cheng Shi Zhi Guang",2017,0,35045171,35045171
3421,"The Skulls",2000,35007180,0,35007180
3422,"Midnight Express",1978,35000000,0,35000000
3423,"Red Heat",1988,34994648,0,34994648
3424,"The Girl in the Spider’s Web",2018,14828555,20154787,34983342
3425,"Richard Pryor Live on the Sunset Strip",1982,34970309,0,34970309
3426,"Camping 2",2010,0,34959667,34959667
3427,"L'arnacouer",2010,504030,34432741,34936771
3428,"Places in the Heart",1984,34900814,0,34900814
3429,"The Bible",1966,34900023,0,34900023
3430,"A Thin Line Between Love & Hate",1996,34873513,0,34873513
3431,"Freddy’s Dead: The Final Nightmare",1991,34872033,0,34872033
3432,"Kidnap",2017,30718107,4117973,34836080
3433,"The November Man",2014,25018119,9802216,34820335
3434,"The Life Aquatic with Steve Zissou",2004,24006726,10800000,34806726
3435,"My Best Friend's Girl",2008,19219250,15567861,34787111
3436,"White Fang",1991,34729091,0,34729091
3437,"Endless Love",2014,23438250,11279923,34718173
3438,"Sammy's avonturen 2",2012,0,34715056,34715056
3439,"Dangerous Liaisons",1988,34700000,0,34700000
3440,"Gekijouban Poketto monsutâ: Kimi ni kimeta!",2017,0,34695344,34695344
3441,"The Other Side of the Mountain",1975,34673100,0,34673100
3442,"Addicted To Love",1997,34673095,0,34673095
3443,"Nixon",1995,13668249,21000000,34668249
3444,"Jack Frost",1998,34645374,0,34645374
3445,"Mia et le lion blanc",2018,348389,34270946,34619335
3446,"The Killing Fields",1984,34609720,0,34609720
3447,"Mississippi Burning",1988,34603000,0,34603000
3448,"Everyone Says I Love You",1996,9725847,24874153,34600000
3449,"Toilet: Ek Prem Katha",2017,709420,33885021,34594441
3450,"The Best Man",1999,34102780,470000,34572780
3451,"Twentieth Century Boys",2008,0,34571688,34571688
3452,"Hawaii",1966,34562222,0,34562222
3453,"That Thing You Do!",1996,25857416,8700000,34557416
3454,"In Bruges",2008,7800825,26732958,34533783
3455,"Les nouvelles aventures d'Aladin",2015,0,34510866,34510866
3456,"Woodstock",1970,34505110,0,34505110
3457,"Malibu's Most Wanted",2003,34308901,190303,34499204
3458,"Heat",1987,34493095,0,34493095
3459,"Last Chance Harvey",2008,14889042,19598160,34487202
3460,"Na xie nian, wo men yi qi zhui de nv hai",2011,0,34480452,34480452
3461,"Broken City",2013,19701164,14778881,34480045
3462,"Breach",2007,33000880,1457899,34458779
3463,"Zambezia",2012,0,34454336,34454336
3464,"The Usual Suspects",1995,23341568,11107788,34449356
3465,"(500) Days of Summer",2009,32425665,2013395,34439060
3466,"Shi gu",2015,188306,34244133,34432439
3467,"The Doors",1991,34416893,0,34416893
3468,"Ta-weo",2012,726,34411177,34411903
3469,"Darkness",2004,22163442,12245764,34409206
3470,"Doraemon: Nobita and the Space Heroes",2015,0,34395038,34395038
3471,"Like Father Like Son",1987,34377585,0,34377585
3472,"Gone, Baby, Gone",2007,20300218,14051944,34352162
3473,"Thoroughly Modern Millie",1967,34335025,0,34335025
3474,"The Gods Must Be Crazy",1984,30031783,4300000,34331783
3475,"Muppet Treasure Island",1996,34327391,0,34327391
3476,"Little Darlings",1980,34326249,0,34326249
3477,"The Wizard of Oz",1939,34063405,242071,34305476
3478,"American Psycho",2000,15070285,19200000,34270285
3479,"Tommy",1975,34251525,884,34252409
3480,"You Will Meet a Tall Dark Stranger",2010,3247816,31000000,34247816
3481,"Viy",2015,0,34246770,34246770
3482,"My Week with Marilyn",2011,14597405,19643167,34240572
3483,"Wings of Courage",1995,15057031,19183063,34240094
3484,"Excalibur",1981,34200000,0,34200000
3485,"Little",2019,29380410,4800000,34180410
3486,"Sling Blade",1996,24475416,9699584,34175000
3487,"Child's Play 2",1990,26904572,7262000,34166572
3488,"Potiche",2011,1618844,32533743,34152587
3489,"Entre les murs",2009,3766810,30347257,34114067
3490,"Instinct",1999,34105207,0,34105207
3491,"My Love, Don't Cross That River",2014,88018,34012260,34100278
3492,"The Edge",1997,27799255,6300000,34099255
3493,"The Truth About Cats & Dogs",1996,34084531,0,34084531
3494,"Swimfan",2002,28564995,5519233,34084228
3495,"Metegol",2013,0,34061097,34061097
3496,"Don 2",2011,3674480,30378610,34053090
3497,"Suffragette",2014,4702420,29342489,34044909
3498,"Flight of the Phoenix",2004,21009180,13000000,34009180
3499,"Golmaal Again",2017,1013893,32992696,34006589
3500,"Day of the Dead",1985,5804262,28200000,34004262
3501,"Bambi II",2006,0,34000000,34000000
3502,"Jane Eyre",2011,11242660,22741195,33983855
3503,"The Relic",1997,33956608,0,33956608
3504,"Ne le dis à personne",2008,6198883,27755135,33954018
3505,"Lockout",2012,14326865,19616184,33943049
3506,"Nochnoy dozor",2006,1502188,32411354,33913542
3507,"Nick and Norah's Infinite Playlist",2008,31487293,2398724,33886017
3508,"The Pink Panther Strikes Again",1976,33833201,0,33833201
3509,"Monkey Magic",2007,0,33824181,33824181
3510,"Adventures in Babysitting",1987,33790923,0,33790923
3511,"Dungeons and Dragons",2000,15185241,18586724,33771965
3512,"Jay and Silent Bob Strike Back",2001,30059386,3703014,33762400
3513,"Porky's II: The Next Day",1983,33759266,0,33759266
3514,"Always zoku san-chôme no yûhi",2007,0,33755260,33755260
3515,"Who's Afraid of Virginia Wolf?",1966,33736689,0,33736689
3516,"Self/Less",2015,12279691,21387628,33667319
3517,"Y Tu Mamá También",2002,13649881,20000000,33649881
3518,"Magic in the Moonlight",2014,10534510,23111162,33645672
3519,"Curly Sue",1991,33644430,0,33644430
3520,"Hostel: Part II",2007,17544812,16061597,33606409
3521,"The Turning Point",1977,33600000,0,33600000
3522,"Nell",1994,33592700,0,33592700
3523,"Friday After Next",2002,33253609,273226,33526835
3524,"King Ralph",1991,33512735,0,33512735
3525,"Run, Fatboy, Run",2008,6003262,27508998,33512260
3526,"Because of Winn-Dixie",2005,32647042,861443,33508485
3527,"The Bad News Bears",2005,32868349,632271,33500620
3528,"Fireproof",2008,33456317,16980,33473297
3529,"Red Planet",2000,17480890,15983079,33463969
3530,"Mystery Men",1999,29762011,3700000,33462011
3531,"The Long Kiss Goodnight",1996,33447612,0,33447612
3532,"The Crocodile Hunter: Collision Course",2002,28436931,5000000,33436931
3533,"Black Knight",2001,33422806,0,33422806
3534,"Wonder Boys",2000,19389454,14033031,33422485
3535,"Rosemary's Baby",1968,33395426,0,33395426
3536,"Planet of the Apes",1968,33395426,0,33395426
3537,"2016: Obama’s America",2012,33349941,0,33349941
3538,"Chek dou",2015,0,33349429,33349429
3539,"Get on Up",2014,30569935,2769933,33339868
3540,"Absence of Malice",1981,33312129,0,33312129
3541,"The Bridge on the River Kwai",1957,33300000,0,33300000
3542,"...And Justice For All",1979,33300000,0,33300000
3543,"Gangcheolbi",2017,0,33276122,33276122
3544,"Fletch Lives",1989,33266859,0,33266859
3545,"Hello, Dolly",1969,33208099,0,33208099
3546,"Silverado",1985,33200000,0,33200000
3547,"Forget Paris",1995,33194512,0,33194512
3548,"Pandora",2016,0,33149995,33149995
3549,"Confessions of a Teenage Drama Queen",2004,29331068,3787786,33118854
3550,"October Sky",1999,32683932,425933,33109865
3551,"Matilda",1996,33098222,0,33098222
3552,"Teen Wolf",1985,33086611,0,33086611
3553,"Hart's War",2002,19076815,14000000,33076815
3554,"The Perks of Being a Wallflower",2012,17742948,15326355,33069303
3555,"Seven Psychopaths",2012,15024049,18011687,33035736
3556,"Mr. Woodcock",2007,25799486,7235759,33035245
3557,"Confessions of a Dangerous Mind",2002,16007718,17006087,33013805
3558,"Salmon Fishing in the Yemen",2012,9041540,23967116,33008656
3559,"Dracula 2000",2000,33000377,0,33000377
3560,"The Last Dragon",1985,33000000,0,33000000
3561,"Heroes",1977,33000000,0,33000000
3562,"Endless Love",1981,33000000,0,33000000
3563,"Tadeo Jones 2: El Secreto del Rey Midas",2017,0,32987181,32987181
3564,"Sharky's Machine",1981,32984898,0,32984898
3565,"Mercury Rising",1998,32983332,0,32983332
3566,"Friday the 13th Part IV: The Final Chapter",1984,32980880,0,32980880
3567,"Feng sheng",2009,0,32977948,32977948
3568,"Victor Frankenstein",2015,5775076,27194133,32969209
3569,"Awake",2007,14373825,18594823,32968648
3570,"88 Minutes",2008,16930884,16024515,32955399
3571,"The Producers: The Movie Musical",2005,19398532,13554463,32952995
3572,"*batteries not included",1987,32945797,0,32945797
3573,"Inside Llewyn Davis",2013,13248209,19695038,32943247
3574,"Darkman",1990,32942739,0,32942739
3575,"Air America",1990,30506847,2407668,32914515
3576,"Project Almanac",2015,22348241,10561196,32909437
3577,"Haunted Castle",2001,13651656,19211870,32863526
3578,"Gantz: Perfect Answer",2011,0,32855277,32855277
3579,"You Again",2010,25702053,7136892,32838945
3580,"Fighting",2009,23091010,9740697,32831707
3581,"Za majikku awâ",2008,0,32813807,32813807
3582,"The Joy Luck Club",1993,32790064,0,32790064
3583,"Luther",2003,5781086,26955793,32736879
3584,"Homeward Bound II: Lost in San Francisco",1996,32709423,0,32709423
3585,"Katy Perry: Part of Me",2012,25326071,7374368,32700439
3586,"The Invention of Lying",2009,18451251,14228013,32679264
3587,"Return to Me",2000,32662299,0,32662299
3588,"Coming Home",1978,32653000,0,32653000
3589,"Tommy Boy",1995,32648673,0,32648673
3590,"The Accidental Tourist",1988,32632000,0,32632000
3591,"Leap Year",2010,25918920,6700000,32618920
3592,"Secret in Their Eyes",2015,20180155,12427864,32608019
3593,"Nobody’s Fool",2018,31713110,876383,32589493
3594,"Bait 3D",2012,0,32588670,32588670
3595,"Kabhi Alvida Naa Kehna",2006,3275443,29300000,32575443
3596,"Harry and the Hendersons",1987,29760613,2800000,32560613
3597,"Adaptation",2002,22498520,10033239,32531759
3598,"Alpha Dog",2007,15309602,17204717,32514319
3599,"Murder by Death",1976,32511047,0,32511047
3600,"Fetih 1453",2012,0,32481209,32481209
3601,"Wan-deuk-i",2011,0,32466461,32466461
3602,"Ba Ba Qu Na Er 2",2015,0,32460000,32460000
3603,"Jing Cheng 81 Hao 2",2017,0,32449600,32449600
3604,"Wild Safari 3D",2005,16621230,15825520,32446750
3605,"Krrish",2006,1430721,31000000,32430721
3606,"The Sandlot",1993,32416586,0,32416586
3607,"Baaghi 2",2018,1319579,31089276,32408855
3608,"Nocturnal Animals",2016,10663357,21735324,32398681
3609,"Being John Malkovich",1999,22858926,9523455,32382381
3610,"The End",1978,30354004,1980473,32334477
3611,"Black Sheep",1996,32330354,0,32330354
3612,"Kevin Hart: Let Me Explain",2013,32244051,83204,32327255
3613,"Nothing in Common",1986,32324000,0,32324000
3614,"La piel que habito",2011,3185193,29115112,32300305
3615,"Deo Tereo Raibeu",2013,0,32230953,32230953
3616,"Justin Bieber’s Believe",2013,6206566,26020215,32226781
3617,"Dance Flick",2009,25794018,6430606,32224624
3618,"Kingpin",1996,25023424,7200000,32223424
3619,"The Lost Boys",1987,32222567,0,32222567
3620,"Rowdy Rathore",2012,777373,31430975,32208348
3621,"Agneepath",2012,1973574,30213296,32186870
3622,"Amazing Grace",2007,21214987,10968723,32183710
3623,"Bai she chuan shuo",2011,18759,32153862,32172621
3624,"The Lawnmower Man",1992,32100816,0,32100816
3625,"The Accused",1988,32078318,0,32078318
3626,"La Pianiste",2002,1900282,30176982,32077264
3627,"Summer of '42",1971,32063634,0,32063634
3628,"Man Tam",2013,0,32061558,32061558
3629,"Cidade de Deus",2003,7563397,24495898,32059295
3630,"Golmaal 3",2010,1132192,30924617,32056809
3631,"Robin Hood",1973,32056467,0,32056467
3632,"Copycat",1995,32051917,0,32051917
3633,"Sunshine",2007,3688560,28342050,32030610
3634,"Metro",1997,32017895,0,32017895
3635,"The Age of Innocence",1993,32014993,0,32014993
3636,"Psycho II",1983,32000000,0,32000000
3637,"Psycho",1960,32000000,0,32000000
3638,"Bounty Hunters",2016,0,31956249,31956249
3639,"Jennifer's Body",2009,16204793,15738608,31943401
3640,"The Apple Dumpling Gang",1975,31916500,0,31916500
3641,"Dressed to Kill",1980,31899000,0,31899000
3642,"Bob & Carol & Ted & Alice",1969,31897253,0,31897253
3643,"The Young Victoria",2009,11001272,20877619,31878891
3644,"Children of a Lesser God",1986,31853080,0,31853080
3645,"The Shadow",1994,31835600,0,31835600
3646,"Wo shi zheng ren",2015,409644,31424661,31834305
3647,"Der Junge muss an die frische Luft",2018,0,31822424,31822424
3648,"Lake Placid",1999,31770413,0,31770413
3649,"Herbie Rides Again",1974,31765098,0,31765098
3650,"Jungle Fever",1991,31739045,0,31739045
3651,"Mr. Nice Guy",1998,12716953,19000000,31716953
3652,"Os Dez Mandamentos: O Filme",2016,0,31689514,31689514
3653,"Pinocchio",2002,3681811,28000000,31681811
3654,"For Richer or Poorer",1997,31680796,0,31680796
3655,"Paint Your Wagon",1969,31678778,0,31678778
3656,"History of the World: Part I",1981,31672000,0,31672000
3657,"Rent",2005,29077547,2593073,31670620
3658,"Koe No Katachi",2016,0,31648638,31648638
3659,"Hard Target",1993,31636358,0,31636358
3660,"The Girl Next Door",2004,14589444,17045706,31635150
3661,"Che, Part 1: The Argentine",2008,1802521,29824849,31627370
3662,"Can’t Buy Me Love",1987,31623833,0,31623833
3663,"Daddy's Little Girls",2007,31366978,242265,31609243
3664,"Le Sens de la Fête",2017,0,31604961,31604961
3665,"Super Troopers 2",2018,30617396,958239,31575635
3666,"Gekijo-ban Sword Art Online: Ordinal Scale",2017,0,31568925,31568925
3667,"Benji",1974,31559560,0,31559560
3668,"Little Big Man",1970,31559552,0,31559552
3669,"Mud",2013,21590086,9966873,31556959
3670,"Benvenuti al nord",2012,0,31546647,31546647
3671,"Lage Raho Munna Bhai",2006,2217561,29300000,31517561
3672,"Yomei Ikkagetsu no Hanayome",2009,0,31510715,31510715
3673,"The Son of Bigfoot",2017,0,31488505,31488505
3674,"Three Heroes on Distant Shores",2012,0,31476575,31476575
3675,"LOL (Laughing Out Loud)",2008,0,31451622,31451622
3676,"The Seeker: The Dark is Rising",2007,8794452,22606288,31400740
3677,"Premium Rush",2012,20275446,11117755,31393201
3678,"Rob Roy",1995,31390587,0,31390587
3679,"Ansatsu kyôshitsu: sotsugyô hen",2016,0,31383049,31383049
3680,"Eddie",1996,31369401,0,31369401
3681,"Mrs Brown's Boys D'Movie",2014,0,31344256,31344256
3682,"An Ideal Husband",1999,18542974,12798209,31341183
3683,"The Iron Giant",1999,23159305,8174612,31333917
3684,"Lost Souls",2000,16779636,14540657,31320293
3685,"Sky of Love",2007,0,31311079,31311079
3686,"Picture Perfect",1997,31301775,0,31301775
3687,"Johnson Family Vacation",2004,31203964,82795,31286759
3688,"Thrill Ride: The Science of Fun",1997,18798682,12480529,31279211
3689,"Robot",2010,2276427,28991065,31267492
3690,"Bustin' Loose",1981,31261000,0,31261000
3691,"Cop and ½",1993,31226971,0,31226971
3692,"How High",2001,31155435,66960,31222395
3693,"The Great Muppet Caper",1981,31206251,0,31206251
3694,"The House",2017,25584504,5607921,31192425
3695,"The Bye Bye Man",2017,22395806,8791921,31187727
3696,"The Secret Garden",1993,31181000,0,31181000
3697,"Perfectos Desconocidos",2017,0,31166312,31166312
3698,"Movie 43",2012,8840453,22324294,31164747
3699,"A Perfect World",1993,31160784,0,31160784
3700,"Joyful Noise",2012,30932113,225801,31157914
3701,"Spring Breakers",2013,14124286,17024965,31149251
3702,"True Grit",1969,31132592,0,31132592
3703,"Those Magnificent Men In Their Flying...",1965,31111111,0,31111111
3704,"Camelot",1967,31102578,0,31102578
3705,"Les Profs",2013,0,31090977,31090977
3706,"Love in the Time of Cholera",2007,4617608,26459810,31077418
3707,"Grosse Pointe Blank",1997,28084357,2986055,31070412
3708,"High Anxiety",1977,31063038,0,31063038
3709,"The Water Diviner",2014,4200117,26854610,31054727
3710,"Igor",2008,19528602,11484747,31013349
3711,"This Is Not What I Expected",2017,337670,30658944,30996614
3712,"Joe Dirt",2001,27087695,3900000,30987695
3713,"The Hurricane Heist",2018,6115824,24847860,30963684
3714,"Ultraviolet",2006,18522064,12440048,30962112
3715,"Paper Moon",1973,30933743,0,30933743
3716,"Vysotsky. Spasibo, Chto Zhivoi",2011,0,30896024,30896024
3717,"Be Kind Rewind",2008,11175164,19719083,30894247
3718,"Hearts in Atlantis",2001,24185781,6700000,30885781
3719,"Zatoichi",2004,853718,30020832,30874550
3720,"The Princess Bride",1987,30857000,2628,30859628
3721,"Masterminds",2016,17356894,13493772,30850666
3722,"Ryan's Daughter",1970,30846306,0,30846306
3723,"Powder",1995,30833914,0,30833914
3724,"Pathfinder",2007,10232081,20590780,30822861
3725,"Gintama 2: Okite wa Yaburu tame ni koso Aru",2018,0,30798089,30798089
3726,"Contratiempo",2017,0,30778309,30778309
3727,"When the Bough Breaks",2016,29747603,1020846,30768449
3728,"Murphy's Romance",1985,30762621,0,30762621
3729,"Nancy Drew",2007,25584685,5119160,30703845
3730,"Sleepless",2017,20783704,9916328,30700032
3731,"Home Alone III",1997,30692437,0,30692437
3732,"Young Doctors in Love",1982,30688860,0,30688860
3733,"Superstar",1999,30628981,0,30628981
3734,"Virus",1999,14010690,16616000,30626690
3735,"Major League II",1994,30626182,0,30626182
3736,"Posledniy bogatyr",2017,0,30618274,30618274
3737,"The Raven",2012,16008272,14593529,30601801
3738,"The Fighting Temptations",2003,30238577,358496,30597073
3739,"Flipper",1996,20080020,10513293,30593313
3740,"Blank Check",1994,30573770,0,30573770
3741,"Norm of the North",2016,17062499,13473161,30535660
3742,"Sleepwalkers",1992,30524763,0,30524763
3743,"From Here to Eternity",1953,30500000,0,30500000
3744,"Chi Bi Juezhan Tianxia",2009,0,30500000,30500000
3745,"2 For the Money",2005,22991379,7500000,30491379
3746,"S Storm",2016,0,30463603,30463603
3747,"Hichki",2018,0,30444106,30444106
3748,"An American Haunting",2006,16298046,14145231,30443277
3749,"The Champ",1979,30441738,0,30441738
3750,"East is East",2000,4170647,26267988,30438635
3751,"Jonas Brothers: The 3D Concert Experience",2009,19162740,11266091,30428831
3752,"Stick It",2006,26910736,3488978,30399714
3753,"Mortdecai",2015,7696134,22700000,30396134
3754,"A Wedding Invitation",2013,14350,30350000,30364350
3755,"A Serious Man",2009,9228788,21131782,30360570
3756,"Meng Chong Guo Jiang",2018,0,30355804,30355804
3757,"Cabin Fever",2003,21158188,9193476,30351664
3758,"Shaun of the Dead",2004,13542874,16789511,30332385
3759,"A Night at the Roxbury",1998,30331165,0,30331165
3760,"Queen of the Damned",2002,30307804,0,30307804
3761,"Say Yes",2013,0,30300000,30300000
3762,"Silmido",2004,298347,30000000,30298347
3763,"American Ultra",2015,14439985,15855043,30295028
3764,"The Great Debaters",2007,30226144,35149,30261293
3765,"Pulse",2006,20264436,9976999,30241435
3766,"Billy Lynn’s Long Halftime Walk",2016,1738477,28491925,30230402
3767,"Weekend at Bernie's",1989,30218387,0,30218387
3768,"The World According to Garp",1982,30207324,0,30207324
3769,"The Art of War",2000,30199105,0,30199105
3770,"Giant",1956,30178619,0,30178619
3771,"Being There",1979,30177511,0,30177511
3772,"What's Your Number?",2011,14011084,16152701,30163785
3773,"Jane Austen's Mafia",1998,19843795,10300000,30143795
3774,"When the Game Stands Tall",2014,30127963,10949,30138912
3775,"Blown Away",1994,30133002,0,30133002
3776,"Night of the Living Dead",1968,12087064,18000000,30087064
3777,"Free Willy 2: The Adventure Home",1995,30077111,0,30077111
3778,"Dragonfly",2002,30063805,0,30063805
3779,"Road House",1989,30050028,0,30050028
3780,"The Chaser",2008,0,30049670,30049670
3781,"Point of No Return",1993,30038362,0,30038362
3782,"Hellboy",2019,19676271,10355000,30031271
3783,"Quo Vadis?",1951,30000000,28513,30028513
3784,"The Sand Pebbles",1966,30017647,0,30017647
3785,"Freebie and the Bean",1974,30000000,0,30000000
3786,"White Christmas",1954,30000000,0,30000000
3787,"Airport '77",1977,30000000,0,30000000
3788,"Chapter Two",1979,30000000,0,30000000
3789,"Rollerball",1975,30000000,0,30000000
3790,"The Strangers: Prey at Night",2018,24431472,5528579,29960051
3791,"Ghost Town",2008,13367624,16590604,29958228
3792,"Laws of Attraction",2004,17848322,12100000,29948322
3793,"Ni Shi Ying Jiu",2017,108970,29836276,29945246
3794,"New in Town",2009,16734283,13203626,29937909
3795,"Small Time Crooks",2000,17266359,12668118,29934477
3796,"Kokowaah 2",2013,0,29924653,29924653
3797,"Neighbors",1981,29916207,0,29916207
3798,"Kler",2018,0,29913342,29913342
3799,"Going in Style",1979,29900000,0,29900000
3800,"7 Zwerge - Der Wald Ist Nicht Genug",2006,0,29900000,29900000
3801,"Mandela: Long Walk to Freedom",2013,8323085,21567317,29890402
3802,"The Four Feathers",2002,18306166,11576479,29882645
3803,"Shorts",2009,20919166,8951635,29870801
3804,"The Losers",2010,23591432,6272408,29863840
3805,"Madeline",1998,29858048,0,29858048
3806,"Draft Day",2014,28842237,1005243,29847480
3807,"St. Trinian’s",2009,15000,29815239,29830239
3808,"Perfetti sconosciuti",2016,0,29829865,29829865
3809,"Double Take",2001,29823162,0,29823162
3810,"Lean on Me",1989,29823140,0,29823140
3811,"Green Card",1990,29804169,0,29804169
3812,"Riding in Cars with Boys",2001,29781453,0,29781453
3813,"Far from the Madding Crowd",2015,12236500,17492950,29729450
3814,"Battlefield Earth: A Saga of the Year 3000",2000,21471685,8253978,29725663
3815,"Tonde Saitama",2019,0,29689840,29689840
3816,"An Education",2009,12574914,17077822,29652736
3817,"The Parent Trap",1961,25150385,4500000,29650385
3818,"Taepung",2006,139059,29453661,29592720
3819,"Una Moglie Bellissima",2007,0,29589994,29589994
3820,"The Swindlers",2017,241916,29330234,29572150
3821,"Si da ming bu",2012,0,29567632,29567632
3822,"L'Ours",1989,29564471,0,29564471
3823,"La grande bellezza",2013,2883879,26665266,29549145
3824,"Tora, Tora, Tora",1970,29548291,0,29548291
3825,"Angel Eyes",2001,24044532,5500000,29544532
3826,"Twilight Zone: The Movie",1983,29500000,0,29500000
3827,"Race 2",2013,1579940,27896094,29476034
3828,"Amsusalin",2018,0,29433930,29433930
3829,"Major Payne",1995,29412050,0,29412050
3830,"Lyod",2018,0,29409365,29409365
3831,"Namhansanseong",2017,138486,29270313,29408799
3832,"The Pledge",2001,19719930,9686202,29406132
3833,"The Evil Dead",1983,2400000,27000000,29400000
3834,"Doraemon: Nobita to Midori no kyojinten",2008,0,29397231,29397231
3835,"De rouille et d’os",2012,2061449,27332185,29393634
3836,"Pacific Heights",1990,29381956,0,29381956
3837,"Across the Universe",2007,24343673,5023470,29367143
3838,"The Prince & Me",2004,28165882,1190875,29356757
3839,"Singh is Kinng",2008,2523511,26816279,29339790
3840,"Ai",2012,0,29338638,29338638
3841,"Wa Pei",2008,0,29338195,29338195
3842,"Hunter Killer",2018,15767460,13557749,29325209
3843,"A Low Down Dirty Shame",1994,29317886,0,29317886
3844,"Easy Money",1983,29309766,0,29309766
3845,"Guan yun chang",2016,0,29307618,29307618
3846,"Yeok-rin",2014,0,29306967,29306967
3847,"Meitantei Konan Zekkai no Puraibeto Ai",2013,0,29302051,29302051
3848,"Shoot to Kill",1988,29300000,0,29300000
3849,"Fools Rush In",1997,29299524,0,29299524
3850,"Wu Xia",2012,11300,29272914,29284214
3851,"Quan Min Mu Ji",2013,0,29260000,29260000
3852,"Zindagi Na Milegi Dobara",2011,3103656,26155616,29259272
3853,"Romy and Michele's High School Reunion",1997,29235353,0,29235353
3854,"The Stepfather",2009,29062561,165000,29227561
3855,"The Road",2009,8114270,21092462,29206732
3856,"Bad Times at the El Royale",2018,17839115,11365264,29204379
3857,"Bulworth",1998,26528684,2674699,29203383
3858,"Jie jiu wu xian sheng",2015,92696,29109231,29201927
3859,"The Rose",1979,29200000,0,29200000
3860,"Rang De Basanti",2006,2197694,27000000,29197694
3861,"Bugs! (IMAX)",2003,19084280,10112664,29196944
3862,"The Object of my Affection",1998,29145924,0,29145924
3863,"Viking",2016,0,29099751,29099751
3864,"Double Impact",1991,29090445,0,29090445
3865,"Irrational Man",2015,4030360,25053237,29083597
3866,"Do-ga-ni",2011,0,29056658,29056658
3867,"3 Ninjas",1992,29028000,0,29028000
3868,"Far From Heaven",2002,15901849,13126065,29027914
3869,"Alibi.com",2017,0,29014614,29014614
3870,"Madonna: Truth or Dare",1991,15012935,14000000,29012935
3871,"Wolf Creek",2005,16186348,12818716,29005064
3872,"The Shaggy Dog",1959,29000000,0,29000000
3873,"House Calls",1978,29000000,0,29000000
3874,"Out to Sea",1997,28985323,0,28985323
3875,"Mr. Holmes",2015,17737646,11241075,28978721
3876,"The New Guy",2002,28972187,0,28972187
3877,"Recep Ivedik 5",2017,0,28965314,28965314
3878,"Mr. Magoo",1997,21437192,7500000,28937192
3879,"James and the Giant Peach",1996,28921264,0,28921264
3880,"The Life of David Gale",2003,19694635,9225553,28920188
3881,"The Guns of Navarone",1961,28900000,19576,28919576
3882,"The Upside of Anger",2005,18761993,10153768,28915761
3883,"Heist",2001,23483357,5423460,28906817
3884,"Padman",2018,1662927,27243759,28906686
3885,"In the Army Now",1994,28881266,0,28881266
3886,"The Player",1992,21706101,7170601,28876702
3887,"Girl, Interrupted",1999,28871190,0,28871190
3888,"Nuts",1987,28866028,0,28866028
3889,"L.A. Story",1991,28854480,0,28854480
3890,"The Adventures of the Wilderness Family",1975,28819175,0,28819175
3891,"Keeping Up with the Joneses",2016,14904426,13900000,28804426
3892,"Samson and Delilah",1949,28800000,0,28800000
3893,"Ghosts of the Abyss",2003,17093668,11687000,28780668
3894,"Case 39",2010,13261851,15511976,28773827
3895,"Boiler Room",2000,16963963,11809674,28773637
3896,"Yu-Gi-Oh",2004,19762690,9000000,28762690
3897,"Deceived",1991,28738096,0,28738096
3898,"Baby Boy",2001,28734552,0,28734552
3899,"The Brothers Grimsby",2016,6864016,21856454,28720470
3900,"Agent Cody Banks 2: Destination London",2004,23514247,5188836,28703083
3901,"Starman",1984,28700000,0,28700000
3902,"Baramgwa hamjje sarajida",2012,0,28686545,28686545
3903,"Yi wen ding qing",2019,0,28657590,28657590
3904,"Wrong Turn",2003,15417771,13231785,28649556
3905,"Carnal Knowledge",1971,28623000,0,28623000
3906,"Hoosiers",1986,28607524,0,28607524
3907,"Drop Zone",1994,28607015,0,28607015
3908,"Jodhaa Akbar",2008,3444629,25150000,28594629
3909,"Final Analysis",1992,28590665,0,28590665
3910,"Singham",2011,350864,28230845,28581709
3911,"W.",2008,25534493,3041285,28575778
3912,"The Kid Who Would Be King",2019,16790790,11765397,28556187
3913,"Nae Anaeui Modeun Geot",2012,0,28555285,28555285
3914,"The Out-of-Towners",1999,28544120,0,28544120
3915,"Splice",2010,17010170,11532324,28542494
3916,"Birigyaru",2015,0,28532888,28532888
3917,"Shingeki no kyojin",2015,258794,28269594,28528388
3918,"Frost/Nixon",2008,18622031,9830914,28452945
3919,"High Road to China",1983,28416459,0,28416459
3920,"The Carpetbaggers",1964,28409547,0,28409547
3921,"Dirty Mary, Crazy Larry",1974,28401735,0,28401735
3922,"The 33",2015,12227722,16172993,28400715
3923,"Meitantei Conan: Ginyoku no kijutsushi",2004,0,28400000,28400000
3924,"Hoffa",1992,23365858,5025615,28391473
3925,"Go!",1999,16875273,11508168,28383441
3926,"Lock, Stock and Two Smoking Barrels",1999,3897569,24458619,28356188
3927,"A Man for All Seasons",1966,28350000,0,28350000
3928,"I Give It a Year",2013,34657,28293874,28328531
3929,"Taxi Driver",1976,28262574,53637,28316211
3930,"Brown Sugar",2002,27362712,952560,28315272
3931,"The Shawshank Redemption",1994,28241469,65623,28307092
3932,"Let Me In",2010,12134935,16135464,28270399
3933,"Thunderbirds",2004,6768055,21463389,28231444
3934,"The Cheap Detective",1978,28221552,0,28221552
3935,"Sin-ui Hansu",2014,0,28211214,28211214
3936,"Marathon Man",1976,28204261,0,28204261
3937,"Ernest Saves Christmas",1988,28202109,0,28202109
3938,"20,000 Leagues Under the Sea",1954,28200000,0,28200000
3939,"Mirai no Mirai",2018,812794,27379973,28192767
3940,"Dirty Harry",1971,28153434,0,28153434
3941,"A Single Man",2009,9176000,18966379,28142379
3942,"Huà Bì",2011,0,28134879,28134879
3943,"Yôkai Watch 3",2016,0,28109609,28109609
3944,"Cannonball Run II",1984,28100000,0,28100000
3945,"That Darn Cat!",1965,28062222,0,28062222
3946,"Police Academy 4: Citizens on Patrol",1987,28061343,0,28061343
3947,"Doogal",2006,7578946,20479706,28058652
3948,"The Beguiled",2017,10576669,17462369,28039038
3949,"Pokemon 4Ever",2002,1732301,26300000,28032301
3950,"Willkommen bei den Hartmanns",2016,0,28023741,28023741
3951,"Cirque du Soleil: Worlds Away",2012,12512862,15500000,28012862
3952,"Slap Shot",1977,28000000,0,28000000
3953,"Herbie Goes to Monte Carlo",1977,28000000,0,28000000
3954,"Loaded Weapon 1",1993,27979399,0,27979399
3955,"When Larry Met Mary",2016,0,27971821,27971821
3956,"The Brothers",2001,27457409,500782,27958191
3957,"The Hindenburg",1975,27945225,0,27945225
3958,"Thugs of Hindostan",2018,1449848,26492922,27942770
3959,"Friday",1995,27467564,469214,27936778
3960,"Appaloosa",2008,20211394,7700059,27911453
3961,"Uncommon Valor",1983,27900000,0,27900000
3962,"Traitor",2008,23530831,4351395,27882226
3963,"Manatsu no hôteishiki",2013,0,27881203,27881203
3964,"Mrs. Henderson Presents",2005,11036366,16800000,27836366
3965,"The Other Sister",1999,27807627,0,27807627
3966,"Playing for Keeps",2012,13103272,14702360,27805632
3967,"RocknRolla",2008,5700626,22093713,27794339
3968,"Internal Affairs",1990,27661878,128026,27789904
3969,"Air Bud",1997,24646936,3141713,27788649
3970,"Saving Grace",2000,12178602,15608247,27786849
3971,"Cirque du Soleil - Journey of Man",2000,15626076,12125705,27751781
3972,"Nurse Betty",2000,25170054,2562312,27732366
3973,"Menace II Society",1993,27731527,0,27731527
3974,"Sou Suo",2012,1037,27720000,27721037
3975,"Love and Basketball",2000,27441122,268503,27709625
3976,"Dark Skies",2013,17418667,10285444,27704111
3977,"Raajneeti",2010,1514557,26188245,27702802
3978,"Teachers",1984,27700000,0,27700000
3979,"To Die For",1995,21284514,6404230,27688744
3980,"The Island of Dr. Moreau",1996,27682712,0,27682712
3981,"Never Cry Wolf",1983,27668764,0,27668764
3982,"Goal! The Dream Begins",2006,4283255,23327618,27610873
3983,"Rear Window",1954,27559601,19863,27579464
3984,"The Thing",2011,16999934,10573144,27573078
3985,"Michael Collins",1996,11092559,16480285,27572844
3986,"Bol Bachchan",2012,1257892,26307892,27565784
3987,"The Last Mimzy",2007,21471047,6048647,27519694
3988,"Boku no Hero Academia the Movie",2018,5427591,22080000,27507591
3989,"The Happytime Murders",2018,20706452,6799960,27506412
3990,"Gukgabudoui Nal",2018,0,27503988,27503988
3991,"Dilwale",2015,4871263,22625703,27496966
3992,"The Muppet Christmas Carol",1992,27281507,211411,27492918
3993,"The Tailor of Panama",2001,13491653,14000000,27491653
3994,"Yesterday Once More",2016,0,27490000,27490000
3995,"My Life",1993,27484464,0,27484464
3996,"Bumchoiwaui junjaeng",2012,0,27482633,27482633
3997,"Ramona and Beezus",2010,26167002,1302619,27469621
3998,"Samyy luchshiy film",2007,0,27464635,27464635
3999,"Ji Jie Hao",2007,0,27455208,27455208
4000,"Victory",1981,10853000,16600000,27453000
4001,"Poetic Justice",1993,27450453,0,27450453
4002,"Dune",1984,27447471,0,27447471
4003,"Schlussmacher",2013,0,27416995,27416995
4004,"Desperately Seeking Susan",1985,27400000,0,27400000
4005,"Daai mo seut si",2013,0,27394383,27394383
4006,"The Incredible Burt Wonderstone",2013,22537881,4854728,27392609
4007,"Memphis Belle",1990,27385582,0,27385582
4008,"Clerks II",2006,24148068,3194178,27342246
4009,"Big Eyes",2014,14482031,12835841,27317872
4010,"Soul Man",1986,27316198,0,27316198
4011,"Welcome",2007,0,27280000,27280000
4012,"Serpico",1973,27274150,0,27274150
4013,"Cadillac Man",1990,27257086,0,27257086
4014,"Dark City",1998,14435076,12821985,27257061
4015,"Zwartboek",2007,4398532,22839822,27238354
4016,"Detective K: Secret of the Lost Island",2015,0,27230725,27230725
4017,"A Passage to India",1984,27187653,0,27187653
4018,"Baby Geniuses",1999,27151490,0,27151490
4019,"Observe and Report",2009,24007324,3141574,27148898
4020,"The Cave",2005,15007991,12140000,27147991
4021,"Mongol",2008,5705761,21441588,27147349
4022,"The Jazz Singer",1981,27118000,0,27118000
4023,"Flash Gordon",1980,27107960,0,27107960
4024,"The Story of Us",1999,27100030,0,27100030
4025,"Fast Times at Ridgemont High",1982,27092880,0,27092880
4026,"Galapagos",1999,18571938,8517904,27089842
4027,"Paulie",1998,27084499,0,27084499
4028,"Now and Then",1995,27067247,0,27067247
4029,"The Big Hit",1998,27066941,0,27066941
4030,"Politseyskiy s Rublyovki. Novogodniy bespredel",2018,0,27061365,27061365
4031,"The Musketeer",2001,27053815,0,27053815
4032,"Monsoon Wedding",2002,13876974,13148626,27025600
4033,"Guarding Tess",1994,27023278,0,27023278
4034,"Legenda No. 17",2013,0,27014935,27014935
4035,"Un monstre à Paris ",2013,0,27000381,27000381
4036,"The Lord of the Rings",1978,27000000,0,27000000
4037,"The Outlaw Josey Wales",1976,27000000,0,27000000
4038,"Relatos salvajes",2014,3107072,23887200,26994272
4039,"Hors de Prix",2008,2164670,24815993,26980663
4040,"Rendition",2007,9736045,17203880,26939925
4041,"Spy Hard",1996,26936265,0,26936265
4042,"Tron",1982,26918576,0,26918576
4043,"You're Next",2013,18494006,8393171,26887177
4044,"Doraemon: Nobita's Great Adventure into the Und…",2007,0,26872950,26872950
4045,"The Way Way Back",2013,21502690,5351120,26853810
4046,"Aku no kyôten",2012,0,26837117,26837117
4047,"Jing mo fung wan: Chen Zhen",2011,50433,26772008,26822441
4048,"Species 2",1998,19217565,7600000,26817565
4049,"Housefull 2",2012,1586745,25229912,26816657
4050,"Judwaa 2",2017,1431255,25366177,26797432
4051,"Shoot 'Em Up",2007,12796824,14000000,26796824
4052,"Zu Zong Shi Jiu Dai",2018,0,26796280,26796280
4053,"The Dream Team",1989,26793650,0,26793650
4054,"Eye for an Eye",1996,26792700,0,26792700
4055,"Ae Dil Hai Mushkil",2016,4264983,22510584,26775567
4056,"Baahubali: The Beginning",2015,6738000,19998665,26736665
4057,"Sorority Row",2009,11965282,14770515,26735797
4058,"A Prairie Home Companion",2006,20342852,6373339,26716191
4059,"A Clockwork Orange",1971,26589355,125869,26715224
4060,"Overboard",1987,26713187,0,26713187
4061,"One True Thing",1998,23337196,3371000,26708196
4062,"The Disaster Artist",2017,21120616,5586194,26706810
4063,"Timeline",2003,19480739,7222445,26703184
4064,"Prizzi's Honor",1985,26700000,0,26700000
4065,"Baby Boom",1987,26700000,0,26700000
4066,"Event Horizon",1997,26673242,0,26673242
4067,"Oliver Twist",2005,2070920,24600000,26670920
4068,"Yattàman",2009,0,26669089,26669089
4069,"Kamera o tomeru na!",2018,0,26649625,26649625
4070,"Gekijouban SPEC: Ten",2012,0,26633141,26633141
4071,"Uchiage Hanabi, Shita Kara Miru ka? Yoko Kara M…",2017,525280,26105422,26630702
4072,"Blast from the Past",1999,26613620,0,26613620
4073,"El Cid",1961,26600000,0,26600000
4074,"Glory",1989,26593580,0,26593580
4075,"The Texas Chainsaw Massacre",1974,26572439,0,26572439
4076,"An American Werewolf in Paris",1997,26570463,0,26570463
4077,"Harriet the Spy",1996,26570048,0,26570048
4078,"The Great Gatsby",1974,26533200,0,26533200
4079,"The Way Back",2011,2719296,23805693,26524989
4080,"Apollo 18",2011,17686929,8830890,26517819
4081,"Gonggongui jeog 3",2008,0,26497132,26497132
4082,"First Kid",1996,26465920,0,26465920
4083,"Conan the Destroyer",1984,26400000,0,26400000
4084,"Upside Down",2012,102118,26284921,26387039
4085,"House Party",1990,26385627,0,26385627
4086,"Kabhi Khushi Kabhie Gham",2001,2862000,23510000,26372000
4087,"Geonchukhakgaeron",2012,0,26369208,26369208
4088,"Dügün Dernek 2: Sünnet",2015,0,26367531,26367531
4089,"The Quiet American",2002,12987647,13360556,26348203
4090,"The Box",2009,15051977,11289919,26341896
4091,"Houseguest",1995,26325256,0,26325256
4092,"Bokura ga ita Zenpen",2012,0,26324268,26324268
4093,"The Whole Ten Yards",2004,16323969,10000000,26323969
4094,"Howards End",1992,26124872,193071,26317943
4095,"The Zookeeper’s Wife",2017,17445186,8863563,26308749
4096,"Protocol",1984,26300000,0,26300000
4097,"Sayonara",1957,26300000,0,26300000
4098,"Wildcats",1986,26285544,0,26285544
4099,"I.Q.",1994,26265119,0,26265119
4100,"Orange",2015,0,26261536,26261536
4101,"Necessary Roughness",1991,26255594,0,26255594
4102,"All Dogs Go To Heaven",1989,26220877,0,26220877
4103,"Dumb and Dumberer: When Harry Met Lloyd",2003,26214846,0,26214846
4104,"Yi Ye Jing Xi",2013,0,26212188,26212188
4105,"Micki + Maude",1984,26200000,0,26200000
4106,"Blood Work",2002,26199517,0,26199517
4107,"The New World",2005,12712093,13472307,26184400
4108,"U2 3D",2008,12898847,13271555,26170402
4109,"Les Couloirs du temps: Les visiteurs 2",1998,146072,26000000,26146072
4110,"Your Highness",2011,21596445,4525193,26121638
4111,"Fair Game",1995,11497497,14600000,26097497
4112,"Torrente 4 (3D)",2012,0,26079076,26079076
4113,"Un gallo con muchos huevos",2015,9080818,16991905,26072723
4114,"Indigènes",2006,320700,25742872,26063572
4115,"Tonari no Totoro",1988,0,26017905,26017905
4116,"The Elephant Man",1980,26010864,0,26010864
4117,"Demetrius and the Gladiators",1954,26000000,9904,26009904
4118,"Do the Right Thing",1989,26004026,0,26004026
4119,"Top Five",2014,25317379,684362,26001741
4120,"Mighty Aphrodite",1995,6401297,19598703,26000000
4121,"Ocean Wonderland",2003,0,26000000,26000000
4122,"Son in Law",1993,25989889,0,25989889
4123,"Love off the Cuff",2017,0,25976828,25976828
4124,"Jacob’s Ladder",1990,25965144,0,25965144
4125,"Sai yau gei: Sin leui kei yun",2014,0,25960664,25960664
4126,"Extreme",1999,12456958,13500000,25956958
4127,"What Happened to Monday?",2017,0,25956932,25956932
4128,"Triple 9",2016,12639297,13304495,25943792
4129,"Freaky Friday",1977,25942000,0,25942000
4130,"Mao's Last Dancer",2010,4806750,21134687,25941437
4131,"Ali G Indahouse",2002,0,25936616,25936616
4132,"The Cotton Club",1984,25928721,0,25928721
4133,"Yeongashi",2012,0,25927961,25927961
4134,"Platinum Data",2013,0,25920896,25920896
4135,"Les invasions barbares",2003,8460000,17453869,25913869
4136,"Yours, Mine and Ours",1968,25912624,0,25912624
4137,"Erinnerungen an die Zukunft",1970,25900000,0,25900000
4138,"Cry Freedom",1987,5899797,20000000,25899797
4139,"Cactus Flower",1969,25889208,0,25889208
4140,"Carrie",1976,25878153,0,25878153
4141,"All About the Benjamins",2002,25482931,390214,25873145
4142,"Saving Silverman",2001,19351569,6521573,25873142
4143,"Our Idiot Brother",2011,24814830,1046419,25861249
4144,"Rollerball",2002,18990542,6861966,25852508
4145,"Shadowlands",1993,25842377,0,25842377
4146,"Murder at 1600",1997,25842024,0,25842024
4147,"White Boy Rick",2018,24004833,1829991,25834824
4148,"Betrayed",1988,25816139,0,25816139
4149,"Only When I Laugh",1981,25782304,0,25782304
4150,"Fading Gigolo",2014,3747833,22022226,25770059
4151,"Bratz",2007,10010209,15737014,25747223
4152,"Nobo no shiro",2012,0,25746258,25746258
4153,"Twenty-Two",2017,22222,25711603,25733825
4154,"From Dusk Till Dawn",1996,25728961,4025,25732986
4155,"Ice Princess",2005,24381334,1351000,25732334
4156,"Das Weisse Band: Eine deutsche Kindergeschichte",2009,2222862,23504182,25727044
4157,"Down Periscope",1996,25723977,0,25723977
4158,"The Outsiders",1983,25697647,0,25697647
4159,"The Wind That Shakes the Barley",2007,1829142,23841032,25670174
4160,"Agnes of God",1985,25627836,0,25627836
4161,"Enough Said",2013,17550872,8070577,25621449
4162,"Jonah: A VeggieTales Movie",2002,25571351,37428,25608779
4163,"Peyton Place",1957,25600000,0,25600000
4164,"9th Company",2005,0,25600000,25600000
4165,"Jumpin' Jack Flash",1986,25587804,0,25587804
4166,"Candyman",1992,25554348,0,25554348
4167,"Funny Farm",1988,25537221,0,25537221
4168,"The Muppets Take Manhattan",1984,25534703,0,25534703
4169,"Halloween II",1981,25533818,0,25533818
4170,"Desperado",1995,25532388,0,25532388
4171,"Paul, Apostle of Christ",2018,17547999,7981499,25529498
4172,"Talaash",2012,2706375,22815915,25522290
4173,"Mimic",1997,25514166,0,25514166
4174,"A Tale of Mari and Three Puppies",2007,0,25513520,25513520
4175,"A Nightmare on Elm Street",1984,25504513,0,25504513
4176,"Rangasthalam",2018,0,25495478,25495478
4177,"Elle s'appelait Sarah",2011,7691700,17788331,25480031
4178,"My Father the Hero",1994,25479558,0,25479558
4179,"Jolly LLB 2",2017,1654254,23807260,25461514
4180,"Billy Madison",1995,25460475,0,25460475
4181,"The Last Exorcism Part II",2013,15179303,10269404,25448707
4182,"Triumph in the Skies",2015,0,25441760,25441760
4183,"Escape from L.A.",1996,25426861,0,25426861
4184,"Badrinath Ki Dulhania",2017,1993259,23430658,25423917
4185,"<U+9006><U+6218> (Jik zin)",2012,0,25414221,25414221
4186,"Tin Men",1987,25411386,0,25411386
4187,"Mr. Donkey",2016,356255,25048315,25404570
4188,"Persepolis",2007,4443403,20953784,25397187
4189,"Aloha",2015,21052030,4335061,25387091
4190,"In America",2003,15539656,9843255,25382911
4191,"The Absent Minded Professor",1961,25381407,0,25381407
4192,"Women's Team Handball",2008,0,25377585,25377585
4193,"In Love and War",1996,14481231,10891063,25372294
4194,"The Cold Light of Day",2012,3763583,21597623,25361206
4195,"Can't Hardly Wait",1998,25358996,0,25358996
4196,"The Last Legion",2007,5932060,19425711,25357771
4197,"Whiskey Tango Foxtrot",2016,23083334,2267413,25350747
4198,"25th Hour",2002,13084595,12259895,25344490
4199,"The Great Race",1965,25333333,0,25333333
4200,"Tinker Bell and the Legend of the Neverbeast",2014,0,25320246,25320246
4201,"Heartburn",1986,25314289,0,25314289
4202,"Fallen",1998,25310938,0,25310938
4203,"Xi Yang Yang Yu Hui Tai Lang Zhi Kaixin Chuang …",2012,0,25310000,25310000
4204,"The Woman in Red",1984,25308147,0,25308147
4205,"Le prénom",2012,61611,25245794,25307405
4206,"Er ist wieder da",2015,0,25283394,25283394
4207,"Bride & Prejudice",2005,6601079,18667961,25269040
4208,"Big Miracle",2012,20157300,5111380,25268680
4209,"Irma La Douce",1963,25246588,0,25246588
4210,"Escape from New York",1981,25244700,1225,25245925
4211,"The Magdalene Sisters",2003,4890878,20327164,25218042
4212,"Alien Nation",1988,25216243,0,25216243
4213,"Sophie's Choice",1982,25215547,0,25215547
4214,"Black Widow",1987,25205460,0,25205460
4215,"Grace of Monaco",2014,0,25199891,25199891
4216,"Race",2008,1367024,23828811,25195835
4217,"Mr. Turner",2014,3958546,21228480,25187026
4218,"The Morning After",1986,25147055,0,25147055
4219,"Qiàn Nu You Hún",2011,0,25141990,25141990
4220,"Bride Wars",2015,0,25130000,25130000
4221,"Don't Tell Mom the Babysitter's Dead",1991,25122195,0,25122195
4222,"Corky Romano",2001,23978402,1137701,25116103
4223,"Cursed",2005,19294901,5820000,25114901
4224,"Problem Child 2",1991,25104700,0,25104700
4225,"Moscow on the Hudson",1984,25100000,0,25100000
4226,"Against All Odds",1984,25100000,0,25100000
4227,"In the Name of the Father",1993,25096862,0,25096862
4228,"Midnight in the Garden of Good and Evil",1997,25078937,0,25078937
4229,"The Wood",1999,25059640,0,25059640
4230,"Wyatt Earp",1994,25052000,0,25052000
4231,"Ivan Tsarevich i Seryy Volk",2011,0,25047727,25047727
4232,"Mad Money",2008,20668843,4375214,25044057
4233,"Call of Heroes",2016,0,25040561,25040561
4234,"Te shu shen fen",2013,0,25040000,25040000
4235,"Born in China",2016,13873211,11164532,25037743
4236,"Mommie Dearest",1981,19032000,6000000,25032000
4237,"Ernest Goes to Jail",1990,25029569,0,25029569
4238,"Some Like it Hot",1959,25000000,19542,25019542
4239,"The Exorcist III",1990,25011739,0,25011739
4240,"A Midsummer Night's Dream",1999,16071990,8939655,25011645
4241,"Exorcist II: The Heretic",1977,25011000,0,25011000
4242,"Airplane II: The Sequel",1982,25009494,0,25009494
4243,"Thunderbolt and Lightfoot",1974,25000000,0,25000000
4244,"Logan's Run",1976,25000000,0,25000000
4245,"The Stewardesses",1969,13500000,11500000,25000000
4246,"Little Man Tate",1991,24989789,0,24989789
4247,"Les Profs 2",2015,0,24964590,24964590
4248,"Invasion of the Body Snatchers",1978,24946533,0,24946533
4249,"Fright Night",1985,24922237,0,24922237
4250,"Don",2019,137860,24775496,24913356
4251,"Catch-22",1970,24911670,0,24911670
4252,"Before the Devil Knows You're Dead",2007,7085511,17823577,24909088
4253,"Kurtlar vadisi - Irak",2006,0,24906717,24906717
4254,"Recep Ivedik",2008,0,24878340,24878340
4255,"SoulMate",2016,0,24859900,24859900
4256,"Navy SEALs",1990,24824126,0,24824126
4257,"Monsieur Lazhar",2011,3371810,21448091,24819901
4258,"Tai Chi Zero",2012,212094,24578459,24790553
4259,"Quiz Show",1994,24787282,0,24787282
4260,"Tees Maar Khan",2010,1076266,23709305,24785571
4261,"De l'autre côté du périph",2012,8689,24774264,24782953
4262,"Nebraska",2013,17654912,7106448,24761360
4263,"The Man Without a Face",1993,24760338,0,24760338
4264,"To the Fore",2015,0,24745722,24745722
4265,"Hitchcock",2012,6008677,18734167,24742844
4266,"Bushi no ichibun",2007,60910,24663578,24724488
4267,"Gorillas in the Mist",1988,24720479,0,24720479
4268,"Lottery Ticket",2010,24719879,0,24719879
4269,"Seed of Chucky",2004,17016190,7700000,24716190
4270,"Biutiful",2011,5101237,19586287,24687524
4271,"Summer Rental",1985,24671000,0,24671000
4272,"Operation Dumbo Drop",1995,24670346,0,24670346
4273,"Sparkle",2012,24397469,262854,24660323
4274,"The Other Side of Midnight",1977,24652021,0,24652021
4275,"Snezhnaya koroleva 3. Ogon i led",2016,0,24615950,24615950
4276,"Mad Max 2: The Road Warrior",1982,24600832,0,24600832
4277,"The Apartment",1960,18600000,6000000,24600000
4278,"Punch-Drunk Love",2002,17791031,6800000,24591031
4279,"Only the Brave",2017,18340051,6215126,24555177
4280,"Joe Somebody",2001,22770864,1745126,24515990
4281,"In the Valley of Elah",2007,6777741,17711409,24489150
4282,"Jesus Christ Superstar",1973,24477615,0,24477615
4283,"Babysitting 2",2015,0,24476064,24476064
4284,"I Don't Know How She Does It",2011,9659074,14815389,24474463
4285,"Modern Problems",1981,24474312,0,24474312
4286,"The Emerald Forest",1985,24468550,0,24468550
4287,"Notorious",1946,24464742,0,24464742
4288,"Pina",2011,3520458,20940300,24460758
4289,"A Cure for Wellness",2017,8106986,16349994,24456980
4290,"Lucky Lady",1975,24441725,0,24441725
4291,"Jodaeiye Nader az Simin",2011,7098492,17327677,24426169
4292,"Arlington Road",1999,24419219,0,24419219
4293,"In the Heat of the Night",1967,24379978,27669,24407647
4294,"The Shipping News",2001,11405825,13000000,24405825
4295,"Bou Chau Mai Sing",2015,32053,24373245,24405298
4296,"Tsurugidake: Ten no Ki",2009,0,24405079,24405079
4297,"The Founder",2016,12786053,11617139,24403192
4298,"Geugeotmani Nae Sesang",2018,0,24376704,24376704
4299,"Vacancy",2007,19063007,5300000,24363007
4300,"The Next Best Thing",2000,14983572,9372190,24355762
4301,"Huang Jin Da Jie An",2012,0,24350000,24350000
4302,"The In-Laws",2003,20440627,3905032,24345659
4303,"8-nengoshi no hanayome",2017,0,24326715,24326715
4304,"The Choice",2016,18730891,5593585,24324476
4305,"Kambakkht Ishq",2009,1455739,22864442,24320181
4306,"Ooops! Noah is Gone",2015,0,24285049,24285049
4307,"Eiga Kaibutsu-kun",2011,0,24266083,24266083
4308,"Bronco Billy",1980,24265659,0,24265659
4309,"Dolores Claiborne",1995,24262193,0,24262193
4310,"Camping 3",2016,0,24224580,24224580
4311,"M.S. Dhoni: The Untold Story",2016,1801550,22417128,24218678
4312,"Warrior",2011,13657115,10558270,24215385
4313,"Manyeo",2018,0,24214410,24214410
4314,"The People Under the Stairs",1991,24204000,0,24204000
4315,"Renaissance Man",1994,24172899,0,24172899
4316,"Wanderlust",2012,17288155,6871779,24159934
4317,"Iron Eagle",1986,24159872,0,24159872
4318,"The Guru",2003,3051221,21099329,24150550
4319,"Rock Dog",2016,9420546,14727942,24148488
4320,"Anfea: The Answer",2011,0,24136016,24136016
4321,"Dead Presidents",1995,24120194,0,24120194
4322,"Detroit",2017,16790139,7326184,24116323
4323,"The Adventures of Huck Finn",1993,24103594,0,24103594
4324,"Spring Break",1983,24071666,0,24071666
4325,"Ong-Bak",2005,4563167,19499798,24062965
4326,"Body Heat",1981,24058000,0,24058000
4327,"Campeones",2018,0,24052599,24052599
4328,"The Dressmaker",2015,2022115,22019502,24041617
4329,"Swimming Pool",2003,10130108,13891174,24021282
4330,"Youth",2015,2703296,21298277,24001573
4331,"Damien: Omen II",1978,24000000,0,24000000
4332,"An Unmarried Woman",1978,24000000,0,24000000
4333,"Virtuosity",1995,23998226,0,23998226
4334,"Adrenaline Rush: The Science of Risk",2002,16933791,7036640,23970431
4335,"Class Action",1991,23968042,0,23968042
4336,"Kensatsu gawa no zainin",2018,0,23929620,23929620
4337,"Natsume's Book of Friends The Movie: Tied to th…",2018,0,23913019,23913019
4338,"The Alamo",2004,22406362,1505000,23911362
4339,"The Railway Man",2014,4438438,19471772,23910210
4340,"Graduation Day",1981,23894000,0,23894000
4341,"Life as a House",2001,15652637,8236521,23889158
4342,"The Flamingo Kid",1984,23859382,0,23859382
4343,"Hunt for the Wilderpeople",2016,5205471,18640062,23845533
4344,"Bei Tou Zou De Wu Nian",2013,0,23840000,23840000
4345,"Tom and Huck",1995,23837227,0,23837227
4346,"Tamjeong 2",2018,0,23832011,23832011
4347,"Lissi und der wilde Kaiser",2007,0,23828403,23828403
4348,"Da Shang Hai",2012,0,23824720,23824720
4349,"Magic",1978,23800000,0,23800000
4350,"House of Wax",1953,23800000,0,23800000
4351,"Beyond and Back",1978,23800000,0,23800000
4352,"Striking Distance",1993,23798623,0,23798623
4353,"Amy",2015,8413144,15365441,23778585
4354,"Race",2016,19115191,4630581,23745772
4355,"Dickie Roberts: Former Child Star",2003,22734486,1000000,23734486
4356,"Silence",2016,7100177,16626449,23726626
4357,"OSS 117: Le Caire, nid d'espions",2008,303328,23423111,23726439
4358,"Santa Claus",1985,23717291,0,23717291
4359,"Good Burger",1997,23712993,0,23712993
4360,"Two of a Kind",1983,23700000,0,23700000
4361,"In the Cut",2003,4717455,18976191,23693646
4362,"Network",1976,23689877,0,23689877
4363,"Sixteen Candles",1984,23686027,0,23686027
4364,"The Owl and the Pussycat",1970,23681338,0,23681338
4365,"North Country",2005,18324242,5352529,23676771
4366,"Armored",2009,15988876,7672162,23661038
4367,"Love Aaj Kal",2009,2430083,21227349,23657432
4368,"Russian Dolls",2006,326095,23328146,23654241
4369,"Eight Crazy Nights",2002,23607202,0,23607202
4370,"The Great Mouse Detective",1986,23605534,0,23605534
4371,"How to Make an American Quilt",1995,23600020,0,23600020
4372,"The Best Years of Our Lives",1946,23600000,0,23600000
4373,"Baksoogundal",2013,0,23593168,23593168
4374,"Hustle & Flow",2005,22202809,1388974,23591783
4375,"My Blue Heaven",1990,23591472,0,23591472
4376,"Kevin Hart: What Now?",2016,23591043,0,23591043
4377,"Domino",2005,10169202,13404855,23574057
4378,"Oscar",1991,23562716,0,23562716
4379,"God’s Not Dead 2",2016,20773069,2778217,23551286
4380,"Solace",2015,0,23549031,23549031
4381,"No Manches Frida",2016,11528613,12012324,23540937
4382,"The Invisible",2007,20568319,2971947,23540266
4383,"Peng ran xin dong",2015,212508,23303922,23516430
4384,"Ernest Goes to Camp",1987,23509382,0,23509382
4385,"Legend",1986,15502112,8004125,23506237
4386,"Xiao Shi De Zi Dan",2012,0,23490000,23490000
4387,"Hoodlum",1997,23489997,0,23489997
4388,"Wish Upon",2017,14301505,9175840,23477345
4389,"Chinjeolhan geumjassi",2006,211667,23260204,23471871
4390,"Il y a longtemps que je t'aime",2008,3169305,20287323,23456628
4391,"Hum Aapke Hain Kaun...!",1994,0,23450000,23450000
4392,"Moteki",2011,0,23442024,23442024
4393,"Gwi-Hyang",2016,123704,23303953,23427657
4394,"Boys on the Side",1995,23418200,0,23418200
4395,"Henry & June",1990,11011903,12400000,23411903
4396,"Caligula",1980,23400000,0,23400000
4397,"Du zhan",2013,128195,23268503,23396698
4398,"Kingdom Come",2001,23247539,146400,23393939
4399,"Circle of Friends",1995,23389975,0,23389975
4400,"Raging Bull",1980,23380203,0,23380203
4401,"Antwone Fisher",2002,21078145,2289441,23367586
4402,"Reindeer Games",2000,23360779,0,23360779
4403,"Hoodwinked Too: Hood vs. Evil",2011,10143779,13209332,23353111
4404,"Soul Kitchen",2010,276901,23070560,23347461
4405,"Bad Santa 2",2016,17782176,5562937,23345113
4406,"Once",2007,9445857,13877774,23323631
4407,"Middle School: The Worst Years of My Life",2016,20007149,3304144,23311293
4408,"Operation Petticoat",1959,23300000,0,23300000
4409,"Auntie Mame",1958,23300000,0,23300000
4410,"Les femmes du 6ème étage",2011,733294,22562537,23295831
4411,"La misma luna",2008,12590147,10681594,23271741
4412,"[Rec]",2007,0,23266821,23266821
4413,"Beasts of the Southern Wild",2012,12795746,10469386,23265132
4414,"Turkisch fur Anfanger",2012,0,23256073,23256073
4415,"Before Midnight",2013,8110621,15141309,23251930
4416,"It Follows",2015,14674077,8576678,23250755
4417,"Free State of Jones",2016,20810036,2427216,23237252
4418,"Kuai Le Dao Jia",2013,0,23210000,23210000
4419,"Benny & Joon",1993,23202734,0,23202734
4420,"Seems Like Old Times",1980,23200000,0,23200000
4421,"CHiPS",2017,18600152,4590140,23190292
4422,"Stay Alive",2006,23086480,101026,23187506
4423,"Chinatown",1974,23169837,0,23169837
4424,"Joyeux Noël",2006,1054361,22079714,23134075
4425,"The Cutting Edge",1992,23131735,0,23131735
4426,"New Happy Dad and Son 3: Adventure in Russia",2018,0,23130468,23130468
4427,"The Players Club",1998,23047939,0,23047939
4428,"Super Troopers",2002,18492362,4553780,23046142
4429,"The Program",1993,23042200,0,23042200
4430,"The Wanderers",1979,5017811,18000000,23017811
4431,"I Love You, Phillip Morris",2010,2037459,20976568,23014027
4432,"Bulletproof Monk",2003,23010607,0,23010607
4433,"Ghost Dad",1990,23007150,0,23007150
4434,"Same Time, Next Year",1978,23000000,0,23000000
4435,"Lewis & Clark: Great Journey West",2002,0,23000000,23000000
4436,"The Russia House",1990,22998000,0,22998000
4437,"Aquamarine",2006,18597342,4381611,22978953
4438,"African Cats",2011,15428747,7517860,22946607
4439,"Goodbye, Columbus",1969,22939805,0,22939805
4440,"D3: The Mighty Ducks",1996,22936273,0,22936273
4441,"The Care Bears Movie",1985,22934000,0,22934000
4442,"Rounders",1998,22921898,0,22921898
4443,"La Vie d'Adèle – Chapitres 1 & 2",2013,2450504,20463975,22914479
4444,"Ella Enchanted",2004,22913677,0,22913677
4445,"The Ruins",2008,17432844,5477719,22910563
4446,"Crimes of the Heart",1986,22905000,0,22905000
4447,"Baggage Claim",2013,21569509,1316327,22885836
4448,"Lola rennt",1999,7267324,15611870,22879194
4449,"The Glass House",2001,17951431,4910354,22861785
4450,"Alatriste",2007,0,22860477,22860477
4451,"Bu-reo-jin hwa-sal",2012,0,22852811,22852811
4452,"Beloved",1998,22852487,0,22852487
4453,"Paris",2008,1010194,21840000,22850194
4454,"Raising Arizona",1987,22847000,0,22847000
4455,"Won’t You Be My Neighbor?",2018,22835787,9812,22845599
4456,"A Perfect Getaway",2009,15515460,7300000,22815460
4457,"Missing in Action",1984,22812411,0,22812411
4458,"Dr. T and the Women",2000,13065561,9731250,22796811
4459,"Frankie and Johnny",1991,22773535,0,22773535
4460,"Xanadu",1980,22762571,0,22762571
4461,"Santa vs. The Snowman",2002,10259134,12500000,22759134
4462,"Le Scaphandre et le Papillon",2007,5990075,16764397,22754472
4463,"Rudy",1993,22750363,0,22750363
4464,"Young Adult",2011,16311571,6438785,22750356
4465,"Radin!",2016,0,22748811,22748811
4466,"Polisse",2012,176988,22567144,22744132
4467,"After",2019,10435149,12300000,22735149
4468,"The Juror",1996,22730924,0,22730924
4469,"Desu Noto 3: L: Change the World",2008,0,22730665,22730665
4470,"Raia Gemu Saisei",2012,0,22713078,22713078
4471,"The Accidental Husband",2009,0,22707064,22707064
4472,"Prelude to a Kiss",1992,20006730,2690961,22697691
4473,"Shéntàn púsong líng",2019,0,22687180,22687180
4474,"Extraordinary Mission",2017,0,22682660,22682660
4475,"Prophecy",1979,22673340,0,22673340
4476,"Thunderheart",1992,22660758,0,22660758
4477,"Xia You Qiao Mu",2016,31538,22624185,22655723
4478,"Ai Kaen Seupikeu",2017,0,22645503,22645503
4479,"Revenge of the Nerds II: Nerds in Paradise",1987,22642033,0,22642033
4480,"Pure Luck",1991,22641969,0,22641969
4481,"Gekijouban Poketto monsutâ: Minna no Monogatari",2018,0,22630448,22630448
4482,"Guilty as Sin",1993,22622537,0,22622537
4483,"Seupai",2013,0,22614450,22614450
4484,"The French Lieutenant's Woman",1981,22600000,0,22600000
4485,"Bullet to the Head",2013,9489829,13108140,22597969
4486,"Trance",2013,2322593,20271459,22594052
4487,"Drive Me Crazy",1999,17843379,4748072,22591451
4488,"My Tutor",1983,22587000,0,22587000
4489,"The World's Greatest Athlete",1973,22583370,0,22583370
4490,"Lt. Robin Crusoe, U.S.N.",1966,22565634,0,22565634
4491,"Much Ado About Nothing",1993,22549338,0,22549338
4492,"Lionheart",1991,22545360,0,22545360
4493,"Victor/Victoria",1982,22524614,0,22524614
4494,"Captain Ron",1992,22518097,0,22518097
4495,"Hamlet",1990,20710451,1783276,22493727
4496,"The Warriors",1979,22490000,0,22490000
4497,"My Bodyguard",1980,22482952,0,22482952
4498,"Cassandra's Dream",2008,973018,21505120,22478138
4499,"Winter's Tale",2014,12600231,9868389,22468620
4500,"Ba Li Gong Lue",2018,0,22446966,22446966
4501,"Red Corner",1997,22442815,0,22442815
4502,"Disco",2008,0,22437089,22437089
4503,"Chernaya Molniya",2009,0,22435112,22435112
4504,"License to Drive",1988,22434275,0,22434275
4505,"City by the Sea",2002,22433915,0,22433915
4506,"He Got Game",1998,21567853,844095,22411948
4507,"Two Can Play That Game",2001,22235901,155549,22391450
4508,"Yun Nan Chong Gu Yunnan Valley",2018,101516,22268448,22369964
4509,"At First Sight",1999,22365133,0,22365133
4510,"Blue Chips",1994,22359041,0,22359041
4511,"My Fellow Americans",1996,22331846,0,22331846
4512,"The Lion in Winter",1968,22295024,0,22295024
4513,"Leap of Faith",1992,22293343,0,22293343
4514,"The Light Between Oceans",2016,12545979,9735753,22281732
4515,"For the Love of Benji",1977,22257624,0,22257624
4516,"Empire of the Sun",1987,22238696,0,22238696
4517,"Super Size Me",2004,11529368,10704440,22233808
4518,"Bulletproof",1996,21195840,1035000,22230840
4519,"Norma Rae",1979,22228000,0,22228000
4520,"Waitress",2007,19097550,3119633,22217183
4521,"NASCAR: The IMAX Experience",2004,21550235,665000,22215235
4522,"The Last Starfighter",1984,22200789,0,22200789
4523,"The Bermuda Triangle",1979,22200000,0,22200000
4524,"My Blueberry Nights",2008,866778,21332218,22198996
4525,"To Be and To Have",2003,7610471,14572964,22183435
4526,"The Sword in the Stone",1963,22182353,0,22182353
4527,"A Nightmare On Elm Street: The Dream Child",1989,22168359,0,22168359
4528,"The Marine",2006,18844784,3320824,22165608
4529,"Midnight Sun",2018,9561064,12598345,22159409
4530,"House",1986,19444631,2700000,22144631
4531,"Three Kingdoms: Resurrection of the Dragon",2010,0,22139590,22139590
4532,"Son of Flubber",1963,22129412,0,22129412
4533,"Home for the Holidays",1995,17468887,4650382,22119269
4534,"Love Live! The School Idol Movie",2015,0,22115344,22115344
4535,"Ip Man",2010,0,22114423,22114423
4536,"Fifty Shades of Black",2016,11686940,10426135,22113075
4537,"The Medallion",2003,22108977,0,22108977
4538,"A Soldier's Story",1984,22100000,0,22100000
4539,"Man of the House",2005,19699706,2400000,22099706
4540,"Nosotros Los Nobles",2013,19700,22053611,22073311
4541,"Don Juan DeMarco",1995,22032635,0,22032635
4542,"The Man with the Iron Fists",2012,15634090,6384898,22018988
4543,"Seumool",2015,0,22007889,22007889
4544,"Death Wish",1974,22000000,0,22000000
4545,"In Search of Historic Jesus",1980,22000000,0,22000000
4546,"The Wiz",1978,22000000,0,22000000
4547,"The Big Parade",1925,11000000,11000000,22000000
4548,"Meitantei Conan: Senritsu no furu sukoa",2019,0,21997163,21997163
4549,"Tout le Monde Debout",2018,0,21979795,21979795
4550,"Joy Ride",2001,21973182,0,21973182
4551,"Black or White",2015,21571189,399832,21971021
4552,"Unaccompanied Minors",2006,16655224,5315607,21970831
4553,"Feichang Xingyun",2013,0,21970000,21970000
4554,"Love Don't Cost a Thing",2003,21897389,39846,21937235
4555,"Friday the 13th Part V: A New Beginning",1985,21930418,0,21930418
4556,"Boys",1996,21930418,0,21930418
4557,"Herutâ sukerutâ",2012,0,21927919,21927919
4558,"Partner",2007,1062840,20853261,21916101
4559,"The Glass Castle",2017,17273059,4641140,21914199
4560,"Biker Boyz",2003,21908034,0,21908034
4561,"Io, Loro e Lara",2010,0,21903000,21903000
4562,"Flicka",2006,21000147,896220,21896367
4563,"Just Wright",2010,21540363,327302,21867665
4564,"Stan & Ollie",2018,5452726,16407995,21860721
4565,"Reno 911!: Miami",2007,20342161,1509201,21851362
4566,"Only the Lonely",1991,21830957,0,21830957
4567,"Il Postino",1995,21812813,16754,21829567
4568,"Mr. 3000",2004,21800302,26994,21827296
4569,"Melancholia",2011,3030848,18786450,21817298
4570,"The Caine Mutiny",1954,21800000,0,21800000
4571,"Boys and Girls",2000,21799652,0,21799652
4572,"Fair*Game",2010,9540691,12252214,21792905
4573,"Little Voice",1998,4595000,17192233,21787233
4574,"Pokémon the Movie XY: Ring no Chomajin Hoopa",2015,0,21786128,21786128
4575,"Free Solo",2018,17534673,4245748,21780421
4576,"Live by Night",2016,10378555,11395877,21774432
4577,"Little Black Book",2004,20422207,1336164,21758371
4578,"Ricochet",1991,21756163,0,21756163
4579,"Exodus",1960,21750000,0,21750000
4580,"Son of Sardaar",2012,713754,21034074,21747828
4581,"Se Eu Fosse Voce 2",2009,0,21734431,21734431
4582,"Shining Through",1992,21733781,0,21733781
4583,"7 gwanggu",2011,0,21729647,21729647
4584,"Friday the 13th Part 2",1981,21722776,0,21722776
4585,"Lock Up",1989,21717616,0,21717616
4586,"Proud Mary",2018,20868638,840901,21709539
4587,"Cousins",1989,21707236,0,21707236
4588,"The Green Berets",1968,21707027,0,21707027
4589,"The Russians Are Coming, the Russians Are Coming",1966,21693114,0,21693114
4590,"Class",1983,21667789,0,21667789
4591,"White Oleander",2002,16357770,5300000,21657770
4592,"Como agua para chocolate",1993,21656534,0,21656534
4593,"The Rookie",1990,21633874,0,21633874
4594,"Wan Wu Sheng Zhang",2015,0,21630000,21630000
4595,"Doomsday",2008,11008770,10612418,21621188
4596,"Wild Child",2009,0,21618331,21618331
4597,"The Quest",1996,21607190,0,21607190
4598,"Crayon Shin-chan: Fast Asleep! Dreaming World B…",2016,0,21600242,21600242
4599,"Over Her Dead Body",2008,7570127,14025947,21596074
4600,"Pokemon za mubi XY and Z borukenion to kiko (ka…",2016,0,21594899,21594899
4601,"Consenting Adults",1992,21591728,0,21591728
4602,"Ai Qing Gong She",2016,0,21590284,21590284
4603,"Wicker Park",2004,13001257,8575819,21577076
4604,"Kon-Tiki",2012,1517410,20054692,21572102
4605,"Papa ou maman",2015,0,21552188,21552188
4606,"The Rum Diary",2011,13109815,8434917,21544732
4607,"Blackbeard's Ghost",1968,21540050,0,21540050
4608,"Oh God, You Devil!",1984,21538000,0,21538000
4609,"Épouse-moi mon pote",2017,0,21530000,21530000
4610,"The Prison",2017,207481,21315070,21522551
4611,"Army of Darkness",1993,11502976,10000000,21502976
4612,"The Right Stuff",1983,21500000,0,21500000
4613,"Desu Noto",2008,0,21497802,21497802
4614,"The Man Who Wasn't There",2001,7494849,14000000,21494849
4615,"Married to the Mob",1988,21486757,0,21486757
4616,"Enter the Dragon",1973,21483063,0,21483063
4617,"Eiga doraemon: Shin. Nobita no uchû kaitakushi",2009,0,21463266,21463266
4618,"Tough Guys",1986,21458229,0,21458229
4619,"Toys",1992,21452082,0,21452082
4620,"Da Shi Xiong",2018,85624,21366084,21451708
4621,"The Fog",1980,21445318,502,21445820
4622,"A Very Brady Sequel",1996,21443204,0,21443204
4623,"Quigley Down Under",1990,21413105,0,21413105
4624,"Our Family Wedding",2010,20255281,1155265,21410546
4625,"Arn - Tempelriddaren",2007,0,21404122,21404122
4626,"Rhinestone",1984,21400000,0,21400000
4627,"Die Unendliche Geschichte",1984,21300000,92049,21392049
4628,"Daensing Kwin",2012,0,21387594,21387594
4629,"Cold Creek Manor",2003,21384035,0,21384035
4630,"Penelope",2008,10011996,11363170,21375166
4631,"The First Power",1990,21365321,0,21365321
4632,"Center Stage",2000,17200925,4160184,21361109
4633,"Waist Deep",2006,21344312,0,21344312
4634,"8 Seconds",1994,19582455,1759935,21342390
4635,"Captain Fantastic",2016,5879835,15460399,21340234
4636,"The King and I",1956,21300000,0,21300000
4637,"The Bells of St. Mary's",1945,21300000,0,21300000
4638,"The Freshman",1990,21289527,0,21289527
4639,"The Black Cauldron",1985,21288692,0,21288692
4640,"The Apostle",1997,20733485,544285,21277770
4641,"Buried",2010,1044143,20226147,21270290
4642,"Happy-Go-Lucky",2008,3512016,17722163,21234179
4643,"Nazotoki Wa Dinner No Ato De",2013,0,21216502,21216502
4644,"New York Minute",2004,14018364,7197518,21215882
4645,"A Haunted House 2",2014,17329487,3877374,21206861
4646,"Christine",1983,21200000,3795,21203795
4647,"Fame",1980,21202829,0,21202829
4648,"Straight Talk",1992,21202099,0,21202099
4649,"Mister Roberts",1955,21200000,0,21200000
4650,"The Guard",2011,5359774,15837680,21197454
4651,"Raising Cain",1992,21171695,0,21171695
4652,"ATL",2006,21170563,0,21170563
4653,"A Nightmare on Elm Street Part 2: Freddy's Revenge",1985,21163999,0,21163999
4654,"Cujo",1983,21156152,0,21156152
4655,"Coneheads",1993,21153686,0,21153686
4656,"Things Are Tough All Over",1982,21134374,0,21134374
4657,"Stir of Echoes",1999,21133087,0,21133087
4658,"Atrapa la bandera",2015,0,21131406,21131406
4659,"The Divine Weapon",2008,0,21122661,21122661
4660,"Ferngully… The Last Rainforest",1992,21111825,0,21111825
4661,"Minha Vida em Marte",2018,0,21105636,21105636
4662,"Top Secret!",1984,21100000,0,21100000
4663,"Malmoi",2019,0,21099312,21099312
4664,"Very Bad Things",1998,9949470,11145504,21094974
4665,"The Banquet",2007,0,21094782,21094782
4666,"Tales from the Crypt: Demon Knight",1995,21089146,0,21089146
4667,"F/X2",1991,21075831,0,21075831
4668,"Weekend Pass",1984,21058033,0,21058033
4669,"Father Figures",2017,17501244,3537197,21038441
4670,"Punchline",1988,21032000,0,21032000
4671,"Night Shift",1982,21017056,0,21017056
4672,"22 nenme no Kokuhaku: Watashi ga Satsujinhan desu",2017,0,21001632,21001632
4673,"Dracula",1979,21000000,0,21000000
4674,"The World's Greatest Lover",1977,21000000,0,21000000
4675,"Cat People",1982,7000000,14000000,21000000
4676,"High School High",1996,20995023,0,20995023
4677,"A Room with a View",1986,20966644,0,20966644
4678,"La Guerre du feu",1982,20959585,0,20959585
4679,"The Devil's Rejects",2005,17044981,3895447,20940428
4680,"Nosso Lar",2010,0,20932364,20932364
4681,"Der 7bte Zwerg",2015,0,20930000,20930000
4682,"Red Dog",2011,0,20927794,20927794
4683,"El Nino",2014,245,20917740,20917985
4684,"Alad’2",2018,0,20917377,20917377
4685,"Neoeui kyeol hoonsik",2018,0,20901029,20901029
4686,"Khumba",2013,0,20898221,20898221
4687,"Love & Friendship",2016,14016568,6880369,20896937
4688,"Amores Perros",2001,5383834,15500000,20883834
4689,"Mr. Baseball",1992,20883046,0,20883046
4690,"Short Circuit 2",1988,20882000,0,20882000
4691,"The Hitcher",2007,16379582,4476064,20855646
4692,"Grand Prix",1966,20845016,0,20845016
4693,"Super Mario Bros.",1993,20844907,0,20844907
4694,"The Postman",1997,17650704,3190419,20841123
4695,"Georgia Rule",2007,18882880,1936721,20819601
4696,"Le Grand Chef",2007,0,20794760,20794760
4697,"A Thousand Words",2012,18450127,2340359,20790486
4698,"Jason's Lyric",1994,20788730,0,20788730
4699,"Mulholland Drive",2001,7219578,13566395,20785973
4700,"The Air Up There",1994,20782439,0,20782439
4701,"Left Behind",2014,14019924,6749285,20769209
4702,"Hanbando",2006,0,20766123,20766123
4703,"The Dead Zone",1983,20766000,0,20766000
4704,"Hotaru no Hikari",2012,0,20753277,20753277
4705,"Les Lyonnais",2012,0,20747278,20747278
4706,"Boys Don't Cry",1999,11540607,9200393,20741000
4707,"Superfly",2018,20537137,186444,20723581
4708,"Alex Rider: Operation Stormbreaker",2006,659210,20063240,20722450
4709,"Eurotrip",2004,17718223,3000000,20718223
4710,"The Infiltrator",2016,15436808,5281296,20718104
4711,"Friends Mononoke-jima no Naki",2011,0,20715574,20715574
4712,"Best in Show",2000,18621249,2074164,20695413
4713,"Fear",1996,20694623,0,20694623
4714,"Keanu",2016,20591853,96288,20688141
4715,"Sonu Ke Titu Ki Sweety",2018,0,20686846,20686846
4716,"Cat Ballou",1965,20666667,0,20666667
4717,"El Clan",2015,201227,20458327,20659554
4718,"The Man From Snowy River",1982,20659423,0,20659423
4719,"Intersection",1994,20643034,0,20643034
4720,"Iron Will",1994,20623071,0,20623071
4721,"Dead Silence",2007,16574590,4040071,20614661
4722,"Walk Hard: The Dewey Cox Story",2007,18317151,2288902,20606053
4723,"A Christmas Story",1983,20605209,0,20605209
4724,"F/X",1986,20603715,0,20603715
4725,"Country Strong",2010,20218921,383066,20601987
4726,"Bobby",2006,11242801,9355005,20597806
4727,"Cocktail",2012,1027121,19569638,20596759
4728,"Raid",2018,1010385,19578006,20588391
4729,"Speechless",1994,20564705,0,20564705
4730,"Tubelight",2017,930058,19630866,20560924
4731,"The Last Castle",2001,18208078,2333590,20541668
4732,"Easy Virtue",2009,2656784,17880957,20537741
4733,"Porky's Revenge",1985,20518000,0,20518000
4734,"Cock and Bull",2016,82778,20434698,20517476
4735,"Breakthrough",2019,14606925,5900000,20506925
4736,"The Last Picture Show",1971,20505085,0,20505085
4737,"My Life in Ruins",2009,8677425,11800000,20477425
4738,"The Final Conflict",1981,20471000,0,20471000
4739,"Chilgeup gongmuwon",2009,0,20468524,20468524
4740,"The Nutcracker in 3D",2010,195459,20270557,20466016
4741,"Shiwan Ge Lengxiaohua 2",2017,0,20460352,20460352
4742,"The Groove Tube",1974,20447000,0,20447000
4743,"Madhouse",1990,20438179,0,20438179
4744,"Margin Call",2011,5353586,15079641,20433227
4745,"Alien Adventure",2000,5017383,15410295,20427678
4746,"The Adventures of Ford Fairlane",1990,20423389,0,20423389
4747,"Hello Again",1987,20419446,0,20419446
4748,"The Beach Girls",1982,20418789,0,20418789
4749,"Shame",2011,4002293,16410548,20412841
4750,"Kids",1995,7412216,13000000,20412216
4751,"Some Kind of Hero",1982,20400486,0,20400486
4752,"Duel in the Sun",1946,20400000,0,20400000
4753,"The Sapphires",2012,2450867,17944173,20395040
4754,"The Death of Stalin",2017,8041828,12352026,20393854
4755,"Hyeong",2016,51772,20340567,20392339
4756,"F.I.S.T",1978,20388920,0,20388920
4757,"Valentine",2001,20384136,0,20384136
4758,"Inori no maku ga oriru toki",2018,0,20362866,20362866
4759,"Gonjiam: Haunted Asylum",2018,115252,20230328,20345580
4760,"Code of Silence",1985,20345361,0,20345361
4761,"Delhi Belly",2011,1532594,18757072,20289666
4762,"The Namesake",2007,13610521,6678253,20288774
4763,"City Hall",1996,20278055,0,20278055
4764,"Vampires",1998,20268825,0,20268825
4765,"The Incredible Shrinking Woman",1981,20259000,0,20259000
4766,"Action Jackson",1988,20257000,0,20257000
4767,"Mobsters",1991,20246790,0,20246790
4768,"Critical Condition",1987,20240502,0,20240502
4769,"Six Pack",1982,20225989,0,20225989
4770,"The People vs. Larry Flynt",1996,20224840,0,20224840
4771,"An American Tail: Fievel Goes West",1991,20218664,0,20218664
4772,"Sudden Death",1995,20214270,0,20214270
4773,"Jag ar Nyfiken - en film i gult",1969,20200000,0,20200000
4774,"A Force of One",1979,20200000,0,20200000
4775,"Tarzan",2014,0,20200000,20200000
4776,"Die Fälscher",2008,5488570,14711093,20199663
4777,"Hodejegerne",2012,1200010,18988730,20188740
4778,"Barry Lyndon",1975,20000000,169934,20169934
4779,"Life of Brian",1979,20160501,5781,20166282
4780,"Beerfest",2006,19185184,974132,20159316
4781,"Juice",1992,20146800,0,20146800
4782,"Corrina, Corrina",1994,20146496,0,20146496
4783,"Serving Sara",2002,16930185,3215965,20146150
4784,"Gekijoban Kamen Raida Ozu Wandafuru: Shogun to …",2011,0,20145961,20145961
4785,"Multiplicity",1996,20133326,0,20133326
4786,"Love and Death",1975,20123742,0,20123742
4787,"Nanjing! Nanjing!",2009,122558,20000000,20122558
4788,"Hirugao",2017,0,20122010,20122010
4789,"Legends of Oz: Dorothy’s Return",2014,8462347,11645586,20107933
4790,"Another Stakeout",1993,20107504,0,20107504
4791,"Tess",1980,20093330,0,20093330
4792,"Shokubutsu zukan: Unmei no koi, hiroimashita",2016,0,20084529,20084529
4793,"Reign Over Me",2007,19661987,420000,20081987
4794,"Reality Bites",1994,20079850,0,20079850
4795,"Gu Jian Qi Tan Zhi Liu Yue Zhao Ming",2018,0,20079528,20079528
4796,"Dieses bescheuerte Herz",2017,0,20070328,20070328
4797,"Bharat Ane Nenu",2018,2663090,17406688,20069778
4798,"Who Sleeps My Bro",2016,0,20069212,20069212
4799,"Booty Call",1997,20066917,0,20066917
4800,"Stella",1990,20062347,0,20062347
4801,"Blindness",2008,3073392,16979566,20052958
4802,"Saawariya",2007,885574,19166882,20052456
4803,"With Honors",1994,20043254,0,20043254
4804,"Only You",1994,20042048,0,20042048
4805,"Say Anything…",1989,20036737,0,20036737
4806,"Creepshow",1982,20036244,0,20036244
4807,"The Presidio",1988,20036000,0,20036000
4808,"Down to You",2000,20035310,0,20035310
4809,"I Heart Huckabees",2004,12784713,7250000,20034713
4810,"Tai Chi Hero",2013,30830,19985212,20016042
4811,"Another Year",2010,3205706,16799907,20005613
4812,"Taking Care of Business",1990,20005435,0,20005435
4813,"Gao Gen Xie Xian Sheng",2016,0,20003920,20003920
4814,"Breaking Away",1979,20000000,0,20000000
4815,"The Great Waldo Pepper",1975,20000000,0,20000000
4816,"Shane",1953,20000000,0,20000000
4817,"Outland",1981,20000000,0,20000000
4818,"The Kentucky Fried Movie",1977,15000000,5000000,20000000
4819,"Ho Voglia Di Te",2007,0,20000000,20000000
4820,"The Adventure of Sherlock Holmes' Smarter Brother",1975,20000000,0,20000000
4821,"Barefoot in the Park",1967,19994515,0,19994515
4822,"Rubbeldiekatz",2011,0,19954186,19954186
4823,"Sadako 3D",2012,0,19949419,19949419
4824,"Frailty",2002,13110448,6836832,19947280
4825,"crazy/beautiful",2001,16929123,3000000,19929123
4826,"Unfaithfully Yours",1984,19928200,0,19928200
4827,"Un Prophète",2010,2087720,17822904,19910624
4828,"Breathless",1983,19910002,0,19910002
4829,"Soshite chichi ni naru",2013,333678,19563056,19896734
4830,"Fled",1996,17192205,2700000,19892205
4831,"Caché",2005,3647381,16243950,19891331
4832,"Volunteers",1985,19875740,0,19875740
4833,"Hard Rain",1998,19870567,0,19870567
4834,"Get Over It",2001,11560259,8300000,19860259
4835,"Altered States",1980,19853892,0,19853892
4836,"Child's Play 3",1991,14250380,5600000,19850380
4837,"Melinda and Melinda",2005,3826280,16000000,19826280
4838,"Innerspace",1987,19816619,0,19816619
4839,"Buena Vista Social Club",1999,6997620,12811570,19809190
4840,"Prêt-à-Porter",1994,11300653,8506015,19806668
4841,"Royal Treasure (China)",2016,0,19800196,19800196
4842,"If Beale Street Could Talk",2018,14915773,4881431,19797204
4843,"Cruising",1980,19784223,0,19784223
4844,"The Prodigy",2019,14856291,4902737,19759028
4845,"Amelia",2009,14279575,5476502,19756077
4846,"Color of Night",1994,19750470,0,19750470
4847,"Gone Fishin'",1997,19745922,0,19745922
4848,"Betsy's Wedding",1990,19740070,0,19740070
4849,"Young Sherlock Holmes",1985,19739000,0,19739000
4850,"Dad",1989,19738015,0,19738015
4851,"The Cowboy Way",1994,19731505,0,19731505
4852,"Ye Wen hui chuan: Zhang Tianzhi",2018,154022,19572493,19726515
4853,"Lady Sings the Blues",1972,19726490,0,19726490
4854,"Fire in the Sky",1993,19724334,0,19724334
4855,"It Comes at Night",2017,13985117,5735086,19720203
4856,"Summer Catch",2001,19693891,0,19693891
4857,"Youth in Revolt",2010,15285588,4400000,19685588
4858,"Don't Be a Menace to South Central While Drinki…",1996,19674813,0,19674813
4859,"Shackleton's Antarctic Adventure",2001,15553324,4113837,19667161
4860,"Blackhat",2015,8005980,11659024,19665004
4861,"Tucker: The Man and His Dream",1988,19652638,0,19652638
4862,"Neuilly Sa Mère",2009,0,19637575,19637575
4863,"Vampire in Brooklyn",1995,19637147,0,19637147
4864,"Kuffs",1992,19618135,0,19618135
4865,"Go-ji-jeon",2012,0,19603449,19603449
4866,"Nighthawks",1981,14600000,5000000,19600000
4867,"Dead Man Down",2013,10895295,8704679,19599974
4868,"The Serpent and the Rainbow",1988,19595000,0,19595000
4869,"Heavy Metal",1981,19571091,0,19571091
4870,"Before I Go to Sleep",2014,3242457,16321122,19563579
4871,"Jetsons: The Movie",1990,19543985,0,19543985
4872,"The Professionals",1966,19537346,0,19537346
4873,"The Perfect Man",2005,16535005,3000000,19535005
4874,"View from the Top",2003,15614000,3912014,19526014
4875,"Police Academy 5: Assignment: Miami Beach",1988,19510000,0,19510000
4876,"This is the Army",1943,19500000,0,19500000
4877,"La Dolce Vita",1961,19500000,0,19500000
4878,"It Takes Two",1995,19474589,0,19474589
4879,"Friday the 13th Part VI: Jason Lives",1986,19472057,0,19472057
4880,"Mokgyeokja",2018,0,19469123,19469123
4881,"The Babe",1992,17064550,2400000,19464550
4882,"They Shall Not Grow Old",2018,17883971,1564738,19448709
4883,"Andarushia: Megami No Houfuku",2011,0,19446029,19446029
4884,"Crayon Shinchan Vol. 23",2015,0,19445580,19445580
4885,"The Fly II",1989,19441528,0,19441528
4886,"House Party 2",1991,19438638,0,19438638
4887,"Gong fu guan lan",2008,0,19428291,19428291
4888,"Happy Family",2017,0,19425530,19425530
4889,"Doug's 1st Movie",1999,19421271,0,19421271
4890,"Get Carter",2000,14967182,4450000,19417182
4891,"An Innocent Man",1989,19397847,0,19397847
4892,"Zimna wojna",2018,4580048,14801745,19381793
4893,"The Human Stain",2003,5381227,13998160,19379387
4894,"Sekigahara",2017,0,19356048,19356048
4895,"Tuck Everlasting",2002,19161999,182616,19344615
4896,"The Leisure Seeker",2018,3224126,16116412,19340538
4897,"Deep Blue",2005,132261,19200000,19332261
4898,"71: Into the Fire",2010,159335,19162346,19321681
4899,"Joe",1970,19319254,0,19319254
4900,"Rock Star",2001,16991902,2325863,19317765
4901,"Le renard et l'enfant",2008,0,19317689,19317689
4902,"Kono sekai no katasumi ni",2016,0,19309698,19309698
4903,"Little Giants",1994,19306362,0,19306362
4904,"Sheng Tang Wei Ji",2015,0,19305207,19305207
4905,"Posse",1993,18290000,1000000,19290000
4906,"Summer of Sam",1999,19288130,0,19288130
4907,"2046",2005,1442338,17845147,19287485
4908,"Bandidas",2006,0,19282590,19282590
4909,"Memoir of a Murderer",2017,91335,19191200,19282535
4910,"Deathtrap",1982,19282000,0,19282000
4911,"Best Defense",1984,19265302,0,19265302
4912,"Kaguyahime no monogatari",2013,1506975,17737952,19244927
4913,"Geukbisusa",2015,0,19243890,19243890
4914,"Half Past Dead",2002,15567860,3665420,19233280
4915,"Kwik",2012,0,19225149,19225149
4916,"The Principal",1987,19214194,0,19214194
4917,"House Party 3",1994,19194572,0,19194572
4918,"Martin Lawrence Live: RunTelDat",2002,19184820,0,19184820
4919,"Auf der anderen Seite",2008,742349,18442280,19184629
4920,"The Visitor",2008,9427026,9747791,19174817
4921,"Mother",1996,19174217,0,19174217
4922,"Friday the 13th Part VII: The New Blood",1988,19170001,0,19170001
4923,"Ladies in Lavender",2005,6759422,12408873,19168295
4924,"Hiroin shikkaku",2015,0,19161660,19161660
4925,"A Mighty Heart",2007,9176787,9976781,19153568
4926,"The Fox",1968,19146711,0,19146711
4927,"Vanity Fair",2004,16123851,3000000,19123851
4928,"Capitalism: A Love Story",2009,14363397,4758134,19121531
4929,"Oolong Courtyard:Kung Fu School",2018,19065,19091231,19110296
4930,"That's Entertainment",1974,19100000,0,19100000
4931,"The Edge of Seventeen",2016,14431633,4664370,19096003
4932,"Rushmore",1998,17105219,1975216,19080435
4933,"To the Arctic 3D",2012,14537196,4521674,19058870
4934,"The Drop",2014,10724389,8330145,19054534
4935,"Blaze",1989,19049727,0,19049727
4936,"The Replacement Killers",1998,19035741,0,19035741
4937,"Detective Conan: Jolly Roger in Deep Azure",2018,0,19035565,19035565
4938,"Mortal Thoughts",1991,19018321,0,19018321
4939,"Disturbing Behavior",1998,17507368,1506870,19014238
4940,"North Dallas Forty",1979,19010710,0,19010710
4941,"Johnny Mnemonic",1995,19006201,0,19006201
4942,"The Seduction of Joe Tynan",1979,19000000,0,19000000
4943,"The Jolson Story",1946,19000000,0,19000000
4944,"The Octagon",1980,19000000,0,19000000
4945,"Skin Deep",1989,19000000,0,19000000
4946,"The Boys from Brazil",1978,19000000,0,19000000
4947,"Sniper",1993,18994653,0,18994653
4948,"The World's Fastest Indian",2005,5128124,13863164,18991288
4949,"En kongelig affære",2012,1546761,17436516,18983277
4950,"Bed of Roses",1996,18972237,0,18972237
4951,"Akeelah and the Bee",2006,18848430,110994,18959424
4952,"Before I Fall",2017,12241072,6704610,18945682
4953,"Les invisibles",2019,0,18933202,18933202
4954,"Cocoon: The Return",1988,18924919,0,18924919
4955,"Unfair the End",2015,0,18913492,18913492
4956,"The Odd Couple II",1998,18912328,0,18912328
4957,"Desu nôto: Light Up the New World",2016,0,18901839,18901839
4958,"Eyes of Laura Mars",1978,18900000,0,18900000
4959,"Untamed Heart",1993,18899204,0,18899204
4960,"The Guernsey Literary and Potato Peel Pie Society",2018,0,18895038,18895038
4961,"Whip It",2009,13077184,5812788,18889972
4962,"Kazaam",1996,18880508,0,18880508
4963,"Shark Night 3D",2011,18877153,0,18877153
4964,"The Seventh Sign",1988,18875011,0,18875011
4965,"Mine Vaganti",2012,0,18872126,18872126
4966,"Alfie",1966,18871300,0,18871300
4967,"Above the Law",1988,18869631,0,18869631
4968,"Prityazhenie",2017,0,18840776,18840776
4969,"Paternity",1981,18838000,0,18838000
4970,"Gegege no Kitarô: Sennen noroi uta",2008,0,18836036,18836036
4971,"See No Evil",2006,15032800,3795236,18828036
4972,"Under the Rainbow",1981,18826490,0,18826490
4973,"What's New Pussycat",1965,18820000,0,18820000
4974,"Across the Great Divide",1976,18800000,0,18800000
4975,"Macon County Line",1974,18800000,0,18800000
4976,"Suspect",1987,18782400,0,18782400
4977,"The Rebound",2012,0,18774608,18774608
4978,"The Merchant of Venice",2004,3765585,15000000,18765585
4979,"Fu zi xiong bing",2017,0,18764048,18764048
4980,"Jojakdwen doshi",2017,0,18755496,18755496
4981,"The Believers",1987,18753438,0,18753438
4982,"Pillow Talk",1959,18750000,0,18750000
4983,"Asura : The City of Madness",2016,174501,18562127,18736628
4984,"Admission",2013,18007317,726349,18733666
4985,"The Wife",2018,9599982,9133039,18733021
4986,"Jûsan-nin no shikaku",2011,802778,17924662,18727440
4987,"Housefull",2010,1183658,17542642,18726300
4988,"Grande, grosso e Verdone",2008,0,18725496,18725496
4989,"3000 Miles to Graceland",2001,15738632,2970216,18708848
4990,"Joseon Myungtamjung: Heubhyeolgwimaui Bimil",2018,104012,18604387,18708399
4991,"Year of the Dragon",1985,18707466,0,18707466
4992,"Suddenly Seventeen",2016,0,18683303,18683303
4993,"Waiting...",2005,16124543,2548731,18673274
4994,"Anywhere But Here",1999,18653615,0,18653615
4995,"Xiao zhu pei qi guo da nian",2019,131225,18521816,18653041
4996,"Michael Jordan to the MAX",2000,18642318,0,18642318
4997,"Paradise",1991,18634643,0,18634643
4998,"Jigeum Mannareo Gabmida",2018,0,18634127,18634127
4999,"Fired Up",2009,17231291,1377279,18608570
5000,"The Boatniks",1970,18607492,0,18607492
5001,"OMG: Oh My God",2012,0,18602281,18602281
5002,"Blame it on Rio",1984,18600000,0,18600000
5003,"The Gunman",2015,10664749,7929478,18594227
5004,"The Fan",1996,18582965,0,18582965
5005,"Detoroito Metaru Shiti",2008,0,18569470,18569470
5006,"Flight of the Navigator",1986,18564613,0,18564613
5007,"Some Kind of Wonderful",1987,18553948,0,18553948
5008,"The Quick and the Dead",1995,18552460,0,18552460
5009,"An Unfinished Life",2005,8535575,10000000,18535575
5010,"Project X",1987,18532286,0,18532286
5011,"[Rec] 2",2010,27766,18500000,18527766
5012,"De-Lovely",2004,13337299,5187197,18524496
5013,"Winx Club - Il Segreto Del Regno Perduto",2012,0,18523991,18523991
5014,"Lipstick Under My Burka",2017,0,18520527,18520527
5015,"Cutthroat Island",1995,10017322,8500000,18517322
5016,"Pako to Maho no Ehon",2008,0,18508052,18508052
5017,"A Mighty Wind",2003,17583468,921071,18504539
5018,"The Curse of the Jade Scorpion",2001,7496522,11000000,18496522
5019,"Empire",2002,17504595,990849,18495444
5020,"Tian Qi Yu Bao",2018,103053,18382575,18485628
5021,"Singles",1992,18471850,0,18471850
5022,"Casualties of War",1989,18468714,0,18468714
5023,"Santa & Cie",2017,0,18466843,18466843
5024,"Battle of the Sexes",2017,12638526,5806853,18445379
5025,"Heyy Babyy",2007,1411065,17018886,18429951
5026,"Palmeras en la nieve",2015,0,18428243,18428243
5027,"Sugar Hill",1994,18272447,151467,18423914
5028,"Listy Do M3",2017,0,18421612,18421612
5029,"In Search of the Castaways",1962,18415385,0,18415385
5030,"The Quiet Ones",2014,8509867,9903937,18413804
5031,"Desert Flower",2011,44348,18360936,18405284
5032,"Ladyhawke",1985,18400000,0,18400000
5033,"Yôkai Watch 4",2017,0,18395457,18395457
5034,"Sabotage",2014,10508518,7867925,18376443
5035,"Heidi",2015,0,18363295,18363295
5036,"Dorian Gray",2009,0,18353669,18353669
5037,"Rockstar",2011,985912,17361000,18346912
5038,"Sleeper",1973,18344729,0,18344729
5039,"Luomandike xiaowang shi",2016,367278,17973326,18340604
5040,"Zhui bu",2017,0,18339343,18339343
5041,"Big Baker's Unlucky Bear",2017,0,18330044,18330044
5042,"Gooische Vrouwen II",2014,0,18317700,18317700
5043,"Simon Birch",1998,18253415,57176,18310591
5044,"Jagten",2012,687185,17622608,18309793
5045,"That Darn Cat",1997,18301828,0,18301828
5046,"Good Guys Wear Black",1978,18300000,0,18300000
5047,"Geronimo: An American Legend",1993,18296646,0,18296646
5048,"Boangwan",2017,0,18292558,18292558
5049,"Sorry to Bother You",2018,17493096,792464,18285560
5050,"Machete Kills",2013,8008161,10264848,18273009
5051,"Love Affair",1994,18272894,0,18272894
5052,"Eye of the Beholder",2000,16500786,1760079,18260865
5053,"Crimes and Misdemeanors",1989,18254702,0,18254702
5054,"Loser",2000,15464026,2786080,18250106
5055,"Harold & Kumar Go to White Castle",2004,18225165,0,18225165
5056,"Daddy Day Camp",2007,13235267,4974605,18209872
5057,"Dead Men Don't Wear Plaid",1982,18196170,0,18196170
5058,"Getting Even With Dad",1994,18195538,0,18195538
5059,"Repo Men",2010,13942007,4253231,18195238
5060,"Dope",2015,17506470,684361,18190831
5061,"Duck Duck Goose",2018,0,18174818,18174818
5062,"Bears",2014,17780194,371552,18151746
5063,"Chappaquiddick",2018,17395521,752570,18148091
5064,"The Sure Thing",1985,18136000,0,18136000
5065,"Foxcatcher",2014,12096300,6029664,18125964
5066,"Milk Money",1994,18121466,0,18121466
5067,"The Fabulous Baker Boys",1989,18121297,0,18121297
5068,"All the Pretty Horses",2000,15527125,2593142,18120267
5069,"Hell Fest",2018,11107431,7011800,18119231
5070,"Last Man Standing",1996,18115927,0,18115927
5071,"Keeping Mum",2006,1619466,16494571,18114037
5072,"Friends with Money",2006,13368437,4741715,18110152
5073,"Gone",2012,11682205,6417984,18100189
5074,"Five Easy Pieces",1970,18099091,0,18099091
5075,"Wes Craven's New Nightmare",1994,18090181,0,18090181
5076,"DuckTales: The Movie - Treasure of the Lost Lamp",1990,18075331,0,18075331
5077,"Private Lessons",1981,18064851,1923,18066774
5078,"Jo Jo Dancer, Your Life is Calling",1986,18034150,0,18034150
5079,"Ki-sool-ja-deul",2014,0,18029692,18029692
5080,"The Lobster",2015,9196278,8823556,18019834
5081,"Ao Jiao & Pian Jian",2017,0,18019652,18019652
5082,"Everything You Always Wanted to Know",1972,18016290,0,18016290
5083,"Death on the Nile",1978,18000000,2290,18002290
5084,"Hardly Working",1980,18000000,0,18000000
5085,"The Private Eyes",1981,18000000,0,18000000
5086,"Windwalker",1980,18000000,0,18000000
5087,"Ann och Eve - de Erotiska",1970,18000000,0,18000000
5088,"Ice Castles",1978,18000000,0,18000000
5089,"Jeungin",2019,0,17995630,17995630
5090,"Ensemble, c’est tout",2007,0,17988919,17988919
5091,"The Howling",1981,17985000,0,17985000
5092,"Stolen",2012,289773,17677973,17967746
5093,"The Case for Christ",2017,14678714,3288046,17966760
5094,"Used People",1992,17957265,0,17957265
5095,"Bokura ga Ita Kohen",2012,0,17953383,17953383
5096,"Shinobi no kuni",2017,0,17952504,17952504
5097,"Belle et Sébastien 3, le Dernier Chapitre",2018,0,17939744,17939744
5098,"And So It Goes",2014,15160801,2759212,17920013
5099,"The Pom Pom Girls",1976,17900000,0,17900000
5100,"The Crow: City of Angels",1996,17897671,0,17897671
5101,"Julieta",2016,1489848,16407038,17896886
5102,"Delhi 6",2009,879913,17004284,17884197
5103,"Backkom Bear: Agent 008",2017,0,17880000,17880000
5104,"Bedknobs and Broomsticks",1971,17871174,0,17871174
5105,"Antitrust",2001,10965209,6900000,17865209
5106,"Brothers",2015,656688,17200000,17856688
5107,"Sibling Rivalry",1990,17854933,0,17854933
5108,"Boule et Bill",2013,56224,17793891,17850115
5109,"City of Ember",2008,7873007,9958551,17831558
5110,"Todos lo saben",2018,2660165,15158532,17818697
5111,"Honeysuckle Rose",1980,17815212,0,17815212
5112,"The Boston Strangler",1968,17810894,0,17810894
5113,"School for Scoundrels",2006,17807569,0,17807569
5114,"The Contender",2000,17804273,0,17804273
5115,"For Whom the Bell Tolls",1943,17800000,0,17800000
5116,"9 mois ferme",2013,154485,17633270,17787755
5117,"Gaku: Minna no Yama",2011,0,17772865,17772865
5118,"Little Boy",2015,6485961,11283338,17769299
5119,"Halloween 4: The Return of Michael Myers",1988,17768757,0,17768757
5120,"Born Yesterday",1993,17760754,0,17760754
5121,"The Rage: Carrie 2",1999,17760244,0,17760244
5122,"Rokuyon: Zenpen",2016,0,17756876,17756876
5123,"The Big Green",1995,17736619,0,17736619
5124,"Sarkar Raj",2008,1009065,16713933,17722998
5125,"Jue zhan shi shen",2017,0,17721468,17721468
5126,"The Oxford Murders",2010,4803,17699328,17704131
5127,"The Betsy",1978,17700000,0,17700000
5128,"Kapoor & Sons",2016,2607036,15088862,17695898
5129,"High Security Vacation",2009,0,17686092,17686092
5130,"The Big Easy",1987,17685307,0,17685307
5131,"For the Boys",1991,17684580,0,17684580
5132,"Heavy Weights",1995,17671310,0,17671310
5133,"Kit Kittredge: An American Girl",2008,17657973,0,17657973
5134,"Unfair: The Movie",2007,0,17657692,17657692
5135,"That Touch of Mink",1962,17648927,0,17648927
5136,"Scusa ma ti chiamo amore",2008,0,17646235,17646235
5137,"CB4",1993,17642060,0,17642060
5138,"Frantic",1988,17637000,0,17637000
5139,"The Accidental Detective",2015,0,17624124,17624124
5140,"Max Dugan Returns",1983,17613720,0,17613720
5141,"Operation Finale",2018,17612099,0,17612099
5142,"Alice Doesn't Live Here Anymore",1975,17600000,0,17600000
5143,"Swing Vote",2008,16289867,1300000,17589867
5144,"Eye of the Needle",1981,17583000,0,17583000
5145,"Deliver Us From Eva",2003,17573594,0,17573594
5146,"Cat on a Hot Tin Roof",1958,17570324,0,17570324
5147,"Take This Job and Shove It",1981,17569000,0,17569000
5148,"Adventureland",2009,16044025,1509030,17553055
5149,"Wait Until Dark",1967,17550741,0,17550741
5150,"Shiwan Ge Lengxiaohua",2014,0,17550000,17550000
5151,"Fruitvale Station",2013,16098998,1450647,17549645
5152,"Sabaha",2019,0,17542004,17542004
5153,"Hot Dog… The Movie",1984,17540166,0,17540166
5154,"Invasion U.S.A.",1985,17536256,0,17536256
5155,"Mommy",2014,3498695,14037309,17536004
5156,"Lassiter",1984,17513452,0,17513452
5157,"While We're Young",2015,7582065,9921763,17503828
5158,"Johnny Be Good",1988,17500399,0,17500399
5159,"Addicted",2014,17390770,108472,17499242
5160,"Rebound",2005,16809014,683000,17492014
5161,"Beneath the Planet of the Apes",1970,17489009,0,17489009
5162,"Angel",1984,17488564,0,17488564
5163,"White Palace",1990,17487531,0,17487531
5164,"Neerja",2016,1585687,15900000,17485687
5165,"Rachel Getting Married",2008,12796861,4678614,17475475
5166,"Ragtime",1981,17468158,0,17468158
5167,"Glee: The 3D Concert Movie",2011,11862398,5600000,17462398
5168,"My Favorite Year",1982,17458105,0,17458105
5169,"Tristan & Isolde",2006,14734633,2720980,17455613
5170,"Kinsey",2004,10214647,7228882,17443529
5171,"Roll Bounce",2005,17380866,52206,17433072
5172,"A Guy Thing",2003,15543862,1886732,17430594
5173,"Les Triplettes de Belleville",2003,7301288,10101880,17403168
5174,"Half Baked",1998,17394881,0,17394881
5175,"A Street Cat Named Bob",2016,82703,17299990,17382693
5176,"The Mission",1986,17218000,163173,17381173
5177,"Extreme Measures",1996,17378193,0,17378193
5178,"Gegege No Kitarô",2007,0,17369625,17369625
5179,"Si accettano miracoli",2015,0,17368660,17368660
5180,"Born in East L.A.",1987,17355263,0,17355263
5181,"Masters of the Universe",1987,17336370,0,17336370
5182,"Sunshine Cleaning",2009,12062558,5266779,17329337
5183,"My Baby's Daddy",2004,17321573,639,17322212
5184,"To Live and Die in L.A.",1985,17307019,0,17307019
5185,"12 Rounds",2009,12234694,5071954,17306648
5186,"The Matador",2005,12589255,4711583,17300838
5187,"Murder in the First",1995,17300238,0,17300238
5188,"Max Keeble's Big Move",2001,17292381,0,17292381
5189,"Jiao Zhu Chuan",2017,13588,17269548,17283136
5190,"Shenandoah",1965,17268889,0,17268889
5191,"Unplanned",2019,17267243,0,17267243
5192,"Dolphins and Whales Tribes of the Ocean 3D",2008,7714996,9537291,17252287
5193,"Fate Stay/night: Heaven’s Feel I. Presage Flower",2017,0,17245115,17245115
5194,"21 Ke La",2018,0,17241380,17241380
5195,"A Bronx Tale",1993,17239789,0,17239789
5196,"That Old Feeling",1997,16408534,830684,17239218
5197,"Annapolis",2006,17127992,97000,17224992
5198,"A Few Best Men",2012,0,17224539,17224539
5199,"The Phantom",1996,17220599,0,17220599
5200,"Bright Star",2009,4444637,12775454,17220091
5201,"Hudson Hawk",1991,17218916,0,17218916
5202,"Hit & Run",2012,13749300,3467655,17216955
5203,"No Escape",1994,15339030,1874203,17213233
5204,"Election",1999,14943582,2259272,17202854
5205,"All the Right Moves",1983,17200000,0,17200000
5206,"Her Alibi",1989,17195050,0,17195050
5207,"Hardcore Henry",2016,9252038,7935396,17187434
5208,"Angel Heart",1987,17185000,0,17185000
5209,"Sidekicks",1993,17180393,0,17180393
5210,"Monkey Kingdom",2015,16432322,727208,17159530
5211,"Kureyon Shinchan: Bakumori! Kanfu Boizu ~Ramen …",2018,0,17158729,17158729
5212,"Kites",2010,1685269,15469924,17155193
5213,"The Falcon and the Snowman",1985,17130087,0,17130087
5214,"Johnny Dangerously",1984,17124395,0,17124395
5215,"The Lost City of Z",2017,8574339,8547484,17121823
5216,"The NeverEnding Story II: The Next Chapter",1991,17116963,0,17116963
5217,"Von Ryan's Express",1965,17111111,0,17111111
5218,"The Valachi Papers",1972,17106087,0,17106087
5219,"Diabolique",1996,17100266,0,17100266
5220,"Firehouse Dog",2007,13932383,3165914,17098297
5221,"Pet Sematary II",1992,17092453,0,17092453
5222,"Retour chez ma mère",2016,0,17092291,17092291
5223,"Kung Pow: Enter the Fist",2002,16033556,1000000,17033556
5224,"Pandorum",2009,10330853,6702578,17033431
5225,"Freejack",1992,17033142,0,17033142
5226,"Judy Moody and the Not Bummer Summer",2011,15013650,2016232,17029882
5227,"Somewhere",2010,1785645,15237476,17023121
5228,"Boruto: Naruto the Movie",2015,259028,16755523,17014551
5229,"Central do Brasil",1998,5969553,11036605,17006158
5230,"The Delta Force",1986,17005599,0,17005599
5231,"House of 1,000 Corpses",2003,12634962,4370504,17005466
5232,"Everyone's Hero",2006,14523101,2477336,17000437
5233,"Which Way Is Up?",1977,17000000,0,17000000
5234,"W.W. and the Dixie Dancekings",1975,17000000,0,17000000
5235,"For Keeps?",1988,17000000,0,17000000
5236,"Herbie Goes Bananas",1980,17000000,0,17000000
5237,"Kingdom of the Spiders",1977,17000000,0,17000000
5238,"The Country Bears",2002,16988996,0,16988996
5239,"Win a Date with Tad Hamilton!",2004,16980098,0,16980098
5240,"Emperor Holidays",2015,0,16960000,16960000
5241,"Catch That Kid",2004,16703799,255815,16959614
5242,"Jason X",2002,13121555,3830243,16951798
5243,"Bullyparade: Der Film",2017,0,16943484,16943484
5244,"Jury Duty",1995,16941552,0,16941552
5245,"Lover Come Back",1961,16937969,0,16937969
5246,"Lian Zheng Feng Yun",2019,0,16911359,16911359
5247,"Godsend",2004,14334645,2576063,16910708
5248,"Death Sentence",2007,9534258,7373573,16907831
5249,"Looking for Mr. Goodbar",1977,16900000,0,16900000
5250,"The Birth of a Nation",2016,15861566,1029445,16891011
5251,"Sounder",1972,16889761,0,16889761
5252,"Calvary",2014,3600006,13287735,16887741
5253,"Sugar and Spice",2001,13276953,3603846,16880799
5254,"Hysteria",2012,3337194,13538774,16875968
5255,"Georgy Girl",1966,16873162,0,16873162
5256,"Jaane Tu Ya Jaane Na",2008,600922,16268582,16869504
5257,"Rabbit-Proof Fence",2002,6199600,10667328,16866928
5258,"The Old Man and the Gun",2018,11277120,5585518,16862638
5259,"Meitantei Conan: Konjo no Fisuto",2019,0,16838892,16838892
5260,"Le hérisson",2010,828801,16006387,16835188
5261,"Sumaho o otoshita dake na no ni",2018,0,16831582,16831582
5262,"Femme Fatale",2002,6630252,10200000,16830252
5263,"Kiss Kiss, Bang Bang",2005,4235837,12593627,16829464
5264,"Hollywoodland",2006,14426251,2400000,16826251
5265,"Lightning Jack",1994,16821273,0,16821273
5266,"A Touch of Class",1973,16800000,0,16800000
5267,"Valley Girl",1983,16800000,0,16800000
5268,"Heartfall Arises",2016,0,16788620,16788620
5269,"Jaesim",2017,0,16781837,16781837
5270,"Durante la tormenta",2018,0,16778534,16778534
5271,"Andre",1994,16774699,0,16774699
5272,"102 Not Out",2018,1339909,15425303,16765212
5273,"54",1998,16757163,0,16757163
5274,"Salyut-7",2017,0,16755928,16755928
5275,"My Soul to Take",2010,14744435,1983035,16727470
5276,"Battle of the Year",2013,8888355,7835022,16723377
5277,"Kurôzu zero",2007,0,16699857,16699857
5278,"In Darkness",2012,6994218,9698557,16692775
5279,"Total Dhamaal",2019,2167632,14520491,16688123
5280,"True Crime",1999,16676845,0,16676845
5281,"Ich bin dann mal weg",2015,0,16670205,16670205
5282,"Escape Plan 2: Hades",2018,0,16668668,16668668
5283,"Blink",1994,16668552,0,16668552
5284,"Tremors",1990,16667084,0,16667084
5285,"Rough Cut",1980,16656125,0,16656125
5286,"Mai wei",2012,70177,16583311,16653488
5287,"The Hunter",1980,16647800,0,16647800
5288,"Bringing Out The Dead",1999,16640210,0,16640210
5289,"Deep Cover",1992,16639799,0,16639799
5290,"Pride and Prejudice and Zombies",2016,10907291,5731009,16638300
5291,"Digimon: The Movie",2000,9628751,7000000,16628751
5292,"Paparazzi",2004,15712072,900000,16612072
5293,"Silent House",2012,12739737,3871023,16610760
5294,"Reservation Road",2007,101440,16500000,16601440
5295,"Beat Street",1984,16595791,0,16595791
5296,"The Good Girl",2002,14018296,2567207,16585503
5297,"Baby's Day Out",1994,16581575,0,16581575
5298,"Blue Valentine",2010,9737892,6828348,16566240
5299,"Mindhunters",2005,4476235,12090000,16566235
5300,"My Girl 2",1994,16559100,0,16559100
5301,"Wind Guardians",2018,0,16558135,16558135
5302,"Shocker",1989,16554699,0,16554699
5303,"The Frighteners",1996,16553635,0,16553635
5304,"Upgrade",2018,11977130,4576155,16553285
5305,"Transamerica",2006,9015303,7537860,16553163
5306,"National Lampoon's Class Reunion",1982,16550727,0,16550727
5307,"Der Geilste Tag",2016,0,16542357,16542357
5308,"The Life and Times of Judge Roy Bean",1972,16530578,0,16530578
5309,"Miracle on 1st Street",2007,0,16529062,16529062
5310,"Original Sin",2001,16521410,0,16521410
5311,"Krull",1983,16519460,0,16519460
5312,"Sea Rex 3D: Journey to a Prehistoric World",2010,6096582,10418621,16515203
5313,"Belle",2014,10726630,5784718,16511348
5314,"American Dreamz",2006,7314027,9196944,16510971
5315,"Belle et Sébastien, l'aventure continue",2015,0,16503991,16503991
5316,"Der Baader Meinhof Komplex",2009,476270,16022557,16498827
5317,"Arif v 216",2018,0,16495648,16495648
5318,"The Space Between Us",2017,7885294,8596111,16481405
5319,"The War",1994,16480770,0,16480770
5320,"Heart and Souls",1993,16479685,0,16479685
5321,"Terminal Velocity",1994,16478900,0,16478900
5322,"Spacehunter: Adventures in the Forbidden Zone",1983,16478265,0,16478265
5323,"Shi Ba Dong Cun",2017,0,16444489,16444489
5324,"The Powerpuff Girls",2002,11411644,5014057,16425701
5325,"Candy",1968,16408286,0,16408286
5326,"A Change of Seasons",1980,16400000,0,16400000
5327,"Sergeant York",1941,16400000,0,16400000
5328,"Die Wilden Kerle 4",2007,0,16400000,16400000
5329,"I Love You, Beth Cooper",2009,14800725,1581813,16382538
5330,"Forever My Girl",2018,16376066,0,16376066
5331,"Defending Your Life",1991,16371128,0,16371128
5332,"The Words",2012,11494838,4874870,16369708
5333,"Two Lovers",2009,3149034,13200000,16349034
5334,"Monkey Trouble",1994,16344520,0,16344520
5335,"Paranoia",2013,7388654,8952113,16340767
5336,"Burglar",1987,16337355,0,16337355
5337,"Tales from the Darkside: The Movie",1990,16324573,0,16324573
5338,"MacArthur",1977,16320000,0,16320000
5339,"Müslüm",2018,0,16319221,16319221
5340,"The Silencers",1966,16318124,0,16318124
5341,"A Simple Plan",1998,16316273,0,16316273
5342,"Weird Science",1985,16316258,0,16316258
5343,"Muppets From Space",1999,16304786,0,16304786
5344,"Going My Way",1944,16300000,0,16300000
5345,"Howard the Duck",1986,16295774,0,16295774
5346,"Supercop",1996,16270600,0,16270600
5347,"Crossing Delancey",1988,16262000,0,16262000
5348,"The Dish",2001,2252970,14000000,16252970
5349,"Dans la maison",2012,388044,15859418,16247462
5350,"Unfriended: Dark Web",2018,8866745,7376276,16243021
5351,"Black Christmas",2006,16235738,0,16235738
5352,"Dasavatharam",2008,0,16227750,16227750
5353,"Imagine That",2009,16222392,0,16222392
5354,"Unforgettable",2016,11368012,4853199,16221211
5355,"Cool Hand Luke",1967,16217773,0,16217773
5356,"Raw Deal",1986,16209459,0,16209459
5357,"Follow Me Boys",1966,16207116,0,16207116
5358,"Ghost Story",1981,16202210,0,16202210
5359,"The Emperor's Club",2002,14060950,2132763,16193713
5360,"Fei Fa Cao Zuo",2015,0,16180000,16180000
5361,"Missing Link",2019,12976997,3201648,16178645
5362,"Shine a Light",2008,5505267,10668612,16173879
5363,"Un secret",2008,623558,15550000,16173558
5364,"Just Visiting",2001,4777007,11395193,16172200
5365,"House of Sand and Fog",2003,13005485,3152438,16157923
5366,"Richard Pryor Here and Now",1983,16156776,0,16156776
5367,"Mo' Better Blues",1990,16153000,0,16153000
5368,"The Blue Max",1966,16151612,0,16151612
5369,"Men At Work",1990,16151032,0,16151032
5370,"Flirting with Disaster",1996,14853474,1295706,16149180
5371,"Fire Down Below",1997,16148906,0,16148906
5372,"Wes Craven Presents: They",2002,12840842,3300000,16140842
5373,"The Guardian",1990,16140440,0,16140440
5374,"Chocolat",2016,0,16136718,16136718
5375,"D.C. Cab",1983,16134000,0,16134000
5376,"Winter's Bone",2010,6531503,9600048,16131551
5377,"Parkyeol",2017,0,16118577,16118577
5378,"Bright Lights, Big City",1988,16118077,0,16118077
5379,"Death Wish 3",1985,16116878,0,16116878
5380,"Prancer",1989,16115398,0,16115398
5381,"Fukrey Returns",2017,0,16101765,16101765
5382,"Death Wish II",1982,16100000,0,16100000
5383,"No Holds Barred",1989,16093651,0,16093651
5384,"The Prophecy",1995,16091660,0,16091660
5385,"Running Turtle",2009,0,16083981,16083981
5386,"Nanatsu no kaigi",2019,0,16083213,16083213
5387,"Over the Top",1987,16057580,0,16057580
5388,"The Day of the Jackal",1973,16056255,0,16056255
5389,"Raaz 3: The Third Dimension",2012,0,16042498,16042498
5390,"Incendies",2010,6857096,9181247,16038343
5391,"She's Having a Baby",1988,16031707,0,16031707
5392,"Enigma",2002,4298329,11733099,16031428
5393,"Devil in a Blue Dress",1995,16030096,0,16030096
5394,"Above the Rim",1994,16026469,0,16026469
5395,"Purinsesu Toyotomi",2011,0,16019696,16019696
5396,"O (Othello)",2001,16017403,0,16017403
5397,"Gangnam 1970",2015,0,16016282,16016282
5398,"The Ice Storm",1997,8038061,7973914,16011975
5399,"Missing",1982,16000000,0,16000000
5400,"Sinbad and the Eye of the Tiger",1977,16000000,0,16000000
5401,"Our Man Flint",1965,16000000,0,16000000
5402,"Forever Amber",1947,16000000,0,16000000
5403,"Breakout",1975,16000000,0,16000000
5404,"Mom and Dad",1945,16000000,0,16000000
5405,"The Devil and Max Devlin",1981,16000000,0,16000000
5406,"Tyler Perry's The Single Moms Club",2014,15995891,0,15995891
5407,"Qi Shi Qi Tian",2017,0,15988889,15988889
5408,"Drowning Mona",2000,15427192,553184,15980376
5409,"Caveman",1981,15965000,0,15965000
5410,"Armed and Dangerous",1986,15945534,0,15945534
5411,"Cry Wolf",2005,10047674,5895407,15943081
5412,"Next of Kin",1989,15942628,0,15942628
5413,"Chances Are",1989,15939663,0,15939663
5414,"Jason Goes to Hell: The Final Friday",1993,15935068,0,15935068
5415,"Hero At Large",1980,15934737,0,15934737
5416,"Dance With Me",1998,15923354,0,15923354
5417,"Loucas pra Casar",2015,0,15918808,15918808
5418,"Thomas and the Magic Railroad",2000,15911332,0,15911332
5419,"The Conspirator",2011,11538204,4369207,15907411
5420,"Ajab Prem Ki Ghazab Kahani",2009,741238,15165173,15906411
5421,"Gorky Park",1983,15900000,0,15900000
5422,"I, Daniel Blake",2016,260354,15626833,15887187
5423,"Cai Shen Ke Zhan",2011,0,15883398,15883398
5424,"Seer Movie 6: Invincible Puni",2017,0,15874097,15874097
5425,"Haevnen",2011,1008098,14859216,15867314
5426,"Myeong Dang",2018,0,15856608,15856608
5427,"The Next Karate Kid",1994,8751228,7100000,15851228
5428,"Heroine",2012,598668,15237280,15835948
5429,"Kaizoku to yobareta otoko",2016,0,15827405,15827405
5430,"Extraordinary Measures",2010,12482741,3344243,15826984
5431,"Regression",2015,55039,15769335,15824374
5432,"Anonymous",2011,4463292,11352217,15815509
5433,"Kiss Me Goodbye",1982,15782759,0,15782759
5434,"The Gospel",2005,15778152,0,15778152
5435,"Blitz",2011,0,15774948,15774948
5436,"Once Upon a Time in Mumbai",2010,302862,15450150,15753012
5437,"Yolki 6",2017,0,15738222,15738222
5438,"Anjaana Anjaani",2010,854757,14883455,15738212
5439,"Tazza: The High Rollers",2006,0,15732936,15732936
5440,"Jaws 4: The Revenge",1987,15728335,0,15728335
5441,"Wes Craven's Wishmaster",1997,15719109,0,15719109
5442,"Double Dhamaal",2011,543646,15173480,15717126
5443,"The Island",1980,15716828,0,15716828
5444,"Umimachi Diary",2015,467555,15245197,15712752
5445,"Kazoku Wa Tsuraiyo",2016,0,15710608,15710608
5446,"Fanaa",2006,2105351,13601763,15707114
5447,"Avalon",1990,15702685,0,15702685
5448,"High Plains Drifter",1973,15700000,0,15700000
5449,"The Last Station",2010,6617867,9078279,15696146
5450,"Tri bogatyrya: Khod konem",2015,0,15687885,15687885
5451,"Tully",2018,9369755,6315367,15685122
5452,"Larry the Cable Guy: Health Inspector",2006,15680099,0,15680099
5453,"Aile Arasinda",2017,0,15665230,15665230
5454,"Made in Dagenham",2010,1095369,14548827,15644196
5455,"Au revoir là-haut",2017,0,15626976,15626976
5456,"I Love You to Death",1990,15600149,0,15600149
5457,"Ulee's Gold",1997,9054736,6545264,15600000
5458,"Familyhood",2016,0,15582034,15582034
5459,"Continental Divide",1981,15578000,0,15578000
5460,"Rokuyon: Kôhen",2016,0,15570077,15570077
5461,"Billy Bathgate",1991,15565363,0,15565363
5462,"Finding Your Feet",2018,1418682,14145441,15564123
5463,"Murder 2",2011,0,15559302,15559302
5464,"Belle et Sebastien",2013,0,15558631,15558631
5465,"Scouts Guide to the Zombie Apocalypse",2015,3703046,11851809,15554855
5466,"My Boss's Daughter",2003,15549702,0,15549702
5467,"Switch",1991,15545943,0,15545943
5468,"Teiichi no kuni",2017,0,15545390,15545390
5469,"The Getaway",1994,15545115,0,15545115
5470,"Still Smokin",1983,15543000,0,15543000
5471,"The Wild Angels",1966,15541070,0,15541070
5472,"Revenge",1990,15535771,0,15535771
5473,"Shanghai",2012,46425,15459497,15505922
5474,"Corvette Summer",1978,15500000,0,15500000
5475,"The Greatest Story Ever Told",1965,15473333,0,15473333
5476,"Bait",2000,15325127,146842,15471969
5477,"In Too Deep",1999,14026509,1444720,15471229
5478,"The Greatest Game Ever Played",2005,15331289,136977,15468266
5479,"The Weather Man",2005,12482775,2984186,15466961
5480,"The Fountain",2006,10144010,5317628,15461638
5481,"Facing Window",2004,541682,14916723,15458405
5482,"The Jacket",2005,6301131,9151847,15452978
5483,"Pourquoi j'ai pas mangé mon père",2015,0,15451663,15451663
5484,"Youngblood",1986,15448400,0,15448400
5485,"Rocket Man",1997,15448043,0,15448043
5486,"Marrying the Mafia III",2006,0,15447156,15447156
5487,"Mad Love",1995,15446532,0,15446532
5488,"Reversal of Fortune",1990,15445131,0,15445131
5489,"Kang rinpoche",2016,28184,15413005,15441189
5490,"Out of the Furnace",2013,11330849,4103526,15434375
5491,"Catch and Release",2007,15432542,0,15432542
5492,"The Bonfire of the Vanities",1990,15432314,0,15432314
5493,"The Mod Squad",1999,13260050,2155311,15415361
5494,"Touching the Void",2004,4593598,10802927,15396525
5495,"Death Warrant",1990,15394200,0,15394200
5496,"Pulse: A Stomp Odyssey",2002,10086514,5297876,15384390
5497,"Mr. Destiny",1990,15379253,0,15379253
5498,"Il Ricco, il Povero e il Maggiordomo",2014,0,15377544,15377544
5499,"Leviathan",1989,15363560,0,15363560
5500,"The Witches",1990,10360553,5000000,15360553
5501,"Alex & Emma",2003,14208384,1150199,15358583
5502,"She-Devil",1989,15351421,0,15351421
5503,"Primeval",2007,10597734,4740121,15337855
5504,"Les vacances du petit Nicolas",2014,518768,14808621,15327389
5505,"The Haunting of Molly Hartley",2008,13442412,1875845,15318257
5506,"Ak-ui yeon-dae-gi",2015,0,15315552,15315552
5507,"The Assassination of Jesse James by the Coward …",2007,3909149,11404482,15313631
5508,"The Dreamers",2004,2531462,12775651,15307113
5509,"Woody Woodpecker",2017,0,15306475,15306475
5510,"Tamasha",2015,2065487,13239279,15304766
5511,"Mucize",2015,0,15301749,15301749
5512,"Welcome Stranger",1947,15300000,0,15300000
5513,"Ida",2014,3827060,11471295,15298355
5514,"The Goods: Live Hard, Sell Hard",2009,15122676,174642,15297318
5515,"Maiko haaaan!!!",2007,0,15287683,15287683
5516,"Yugo & Lala 4",2018,0,15286513,15286513
5517,"Raavan",2010,708726,14575649,15284375
5518,"Solomon Kane",2012,0,15275793,15275793
5519,"Quick Change",1990,15260154,0,15260154
5520,"Autoreiji: Biyondo",2012,3878,15229555,15233433
5521,"Kureyon Shinchan: Shurai! Uchujin Shiriri",2017,0,15227612,15227612
5522,"Mix",2017,0,15224207,15224207
5523,"Miss Bala",2019,14998027,219279,15217306
5524,"Benji the Hunted",1987,15212539,0,15212539
5525,"North East: Past Po Ma Zhang Fei",2017,0,15208575,15208575
5526,"Hyeobsang",2018,109856,15096922,15206778
5527,"Sweet Sweetback's Baad Asssss Song",1971,15200000,0,15200000
5528,"Celda 211",2009,0,15200000,15200000
5529,"The Long Riders",1980,15198912,0,15198912
5530,"First Family",1980,15198912,0,15198912
5531,"The Queen's Corgi",2019,0,15198104,15198104
5532,"Snezhnaya koroleva",2012,0,15193977,15193977
5533,"Bad Girls",1994,15187851,0,15187851
5534,"Needful Things",1993,15185672,0,15185672
5535,"Muriel's Wedding",1995,15185000,0,15185000
5536,"Miss Pettigrew Lives for a Day",2008,12313694,2859259,15172953
5537,"Thinner",1996,15171475,0,15171475
5538,"The Corruptor",1999,15164492,0,15164492
5539,"Shingeki no kyojin endo obu za wârudo",2014,243356,14918255,15161611
5540,"Chasing Amy",1997,12006514,3148581,15155095
5541,"Iris",2001,5580479,9574542,15155021
5542,"Three",2016,119550,15023705,15143255
5543,"Paradaisu Kisu",2011,0,15141014,15141014
5544,"La science des rêves",2006,4670644,10467288,15137932
5545,"Firestarter",1984,15136870,0,15136870
5546,"Halloween: The Curse of Michael Myers",1995,15126948,0,15126948
5547,"The Madness of King George",1994,15122669,0,15122669
5548,"Big Top Pee-Wee",1988,15122324,0,15122324
5549,"Io sono l’amore",2010,5005465,10116063,15121528
5550,"The Painted Veil",2006,8060487,7058308,15118795
5551,"Pitbull: Niebezpieczne Kobiety",2016,0,15118739,15118739
5552,"Partners: The Movie IV",2017,0,15104791,15104791
5553,"Soratobu taiya",2018,0,15101476,15101476
5554,"Bhool Bhulaiyaa",2007,1097797,13992242,15090039
5555,"Toy Soldiers",1991,15073942,0,15073942
5556,"Dead Man on Campus",1998,15064948,0,15064948
5557,"Paradise Murdered",2007,0,15061334,15061334
5558,"King Solomon's Mines",1985,15057465,0,15057465
5559,"Le tout nouveau testament",2015,127910,14927251,15055161
5560,"Twilight",1998,15055091,0,15055091
5561,"The Reef",2010,0,15037867,15037867
5562,"The Pyramid",2014,2756333,12274961,15031294
5563,"Zapped!",1982,15026217,0,15026217
5564,"Haakon Haakonsen",1991,15024232,0,15024232
5565,"Trick: The Movie 2",2006,0,15016774,15016774
5566,"Snezhnaya koroleva 2",2014,0,15002576,15002576
5567,"The Front Page",1974,15000000,0,15000000
5568,"Mother, Jugs & Speed",1976,15000000,0,15000000
5569,"Breakin' 2: Electric Boogaloo",1984,15000000,0,15000000
5570,"The Egyptian",1954,15000000,0,15000000
5571,"Spaced Invaders",1990,15000000,0,15000000
5572,"The V.I.P.s",1963,15000000,0,15000000
5573,"Obitaemyy ostrov",2009,0,15000000,15000000
5574,"Pete 'n' Tillie",1972,14999969,0,14999969
5575,"Loving Pablo",2017,22017,14972838,14994855
5576,"Ek Main Aur Ekk Tu",2012,1155545,13822484,14978029
5577,"Solaris",2002,14970038,0,14970038
5578,"Matrimonio alle Bahamas",2007,0,14964621,14964621
5579,"Chak De India",2007,1113541,13845785,14959326
5580,"Médecin de campagne",2016,0,14953945,14953945
5581,"The Music Man",1962,14953846,0,14953846
5582,"Love & Mercy",2015,12551031,2398877,14949908
5583,"Kiss of Death",1995,14942422,0,14942422
5584,"The Hudsucker Proxy",1994,2816518,12121631,14938149
5585,"Boat Trip",2003,8586376,6347337,14933713
5586,"Monty Python's The Meaning of Life",1983,14929552,0,14929552
5587,"The Vatican Tapes",2015,1784763,13144421,14929184
5588,"Baarìa",2011,0,14924887,14924887
5589,"Emperor",2013,3346264,11559205,14905469
5590,"Jue Shi Gao Shou",2017,0,14897163,14897163
5591,"L'école buissonnière",2017,6300,14874207,14880507
5592,"The Game Changer",2017,0,14875966,14875966
5593,"S.O.B.",1981,14867086,0,14867086
5594,"Dogville",2004,1530386,13321268,14851654
5595,"Once Around",1991,14851000,0,14851000
5596,"Music of the Heart",1999,14849583,0,14849583
5597,"Pink Floyd: The Wall",1982,14844106,0,14844106
5598,"Eve's Bayou",1997,14843425,0,14843425
5599,"Hollywood Ending",2002,4839383,10000000,14839383
5600,"Supernova",2000,14218868,597626,14816494
5601,"Flyboys",2006,13090630,1725749,14816379
5602,"All I Want For Christmas",1991,14812144,0,14812144
5603,"Raise Your Voice",2004,10411980,4400000,14811980
5604,"A Dangerous Method",2011,5702083,9105448,14807531
5605,"Possession",2002,10103647,4702165,14805812
5606,"Going by the Book",2007,0,14800000,14800000
5607,"Xing Fu Ma Shang Lai",2018,0,14798770,14798770
5608,"Ladybugs",1992,14796494,0,14796494
5609,"Prom Night",1980,14796236,0,14796236
5610,"Threesome",1994,14793701,0,14793701
5611,"Radio Days",1987,14792779,0,14792779
5612,"Not Without My Daughter",1991,14789113,0,14789113
5613,"Out Cold",2001,13906394,880000,14786394
5614,"Inherent Vice",2014,8110975,6661371,14772346
5615,"A Kiss Before Dying",1991,14769755,0,14769755
5616,"The Sixth Man",1997,14765099,0,14765099
5617,"Fire Birds",1990,14760451,0,14760451
5618,"Les Émotifs anonymes",2011,0,14737098,14737098
5619,"I Hate Luv Storys",2010,847993,13872571,14720564
5620,"Orca",1977,14717854,0,14717854
5621,"Indian Summer",1993,14717851,0,14717851
5622,"School Ties",1992,14715067,0,14715067
5623,"Deutschland: Ein Sommermarchen",2006,0,14700000,14700000
5624,"Educating Rita",1983,14688000,0,14688000
5625,"Khiladi 786",2012,385422,14298341,14683763
5626,"Iron Monkey",2001,14681661,0,14681661
5627,"Arthur 2: On the Rocks",1988,14681192,0,14681192
5628,"Case départ",2011,0,14679847,14679847
5629,"The Substitute",1996,14675167,0,14675167
5630,"Marina Abramovic: The Artist Is Present",2012,86637,14576364,14663001
5631,"The Nude Bomb",1980,14662035,0,14662035
5632,"Thank You",2011,463540,14196505,14660045
5633,"Hello, My Name is Doris",2016,14444999,211196,14656195
5634,"Blood-Soaked GuangChang",2018,0,14651659,14651659
5635,"Freedomland",2006,12512886,2138330,14651216
5636,"Winning",1969,14644335,0,14644335
5637,"Ayla",2017,0,14639765,14639765
5638,"A Life Less Ordinary",1997,4287595,10345675,14633270
5639,"Sword Master",2016,75526,14555037,14630563
5640,"The Beauty Inside",2015,108238,14517521,14625759
5641,"Soldier",1998,14623082,0,14623082
5642,"Beyond the Lights",2014,14618727,0,14618727
5643,"Birth",2004,5005899,9597102,14603001
5644,"Jackie Chan’s First Strike",1997,14601662,0,14601662
5645,"Children of the Corn",1984,14600000,0,14600000
5646,"Night of the Comet",1984,14600000,0,14600000
5647,"High & Low: The Movie",2016,0,14590783,14590783
5648,"Kiss of the Spider Woman",1985,14582182,0,14582182
5649,"Enfin Veuve",2008,0,14580557,14580557
5650,"Hellraiser",1987,14564000,11148,14575148
5651,"Naeaneui Geunom",2019,0,14569310,14569310
5652,"Envy",2004,13548322,1017924,14566246
5653,"Cilada.com",2011,0,14563149,14563149
5654,"Wild at Heart",1990,14560000,0,14560000
5655,"Bikur Ha-Tizmoret",2008,3053823,11502061,14555884
5656,"Soul Plane",2004,13922211,631596,14553807
5657,"Willard",1971,14545941,0,14545941
5658,"School Daze",1988,14545844,0,14545844
5659,"The Salt of the Earth",2014,1343349,13201017,14544366
5660,"The Vanishing",1993,14543394,0,14543394
5661,"Colette",2018,5126985,9415114,14542099
5662,"Mune, le gardien de la lune",2015,0,14534046,14534046
5663,"Kickboxer",1989,14533681,0,14533681
5664,"Deux jours à Paris",2007,4433994,10087671,14521665
5665,"Red Lights",2012,49521,14469363,14518884
5666,"Wadjda",2012,1342455,13162647,14505102
5667,"Oh, God! Book II",1980,14504277,0,14504277
5668,"McLintock!",1963,14500000,0,14500000
5669,"Haha to Kuraseba",2015,0,14489836,14489836
5670,"Being Julia",2004,7739049,6749656,14488705
5671,"¿Qué Culpa Tiene el Niño?",2016,0,14485666,14485666
5672,"King of Kings",1961,14483352,0,14483352
5673,"Psycho III",1986,14481606,0,14481606
5674,"Madeo",2010,551509,13920878,14472387
5675,"Flight of the Intruder",1991,14471440,0,14471440
5676,"Welcome to Mooseport",2004,14469428,0,14469428
5677,"Megan Leavey",2017,13406304,1058534,14464838
5678,"Pattaya",2016,0,14452133,14452133
5679,"Life, or Something Like It",2002,14448589,0,14448589
5680,"Mayakwang",2018,0,14446477,14446477
5681,"America: Imagine a World Without Her",2014,14444502,0,14444502
5682,"Maria Full of Grace",2004,6529624,7911534,14441158
5683,"Superlópez",2018,0,14424823,14424823
5684,"Boku wa Ashita, Kinou no Kimi to Dêto Suru",2016,0,14421696,14421696
5685,"The Chamber",1996,14407578,0,14407578
5686,"Los ojos de Julia",2011,0,14404529,14404529
5687,"Woodlawn",2015,14394097,9606,14403703
5688,"Halloween 3: Season of the Witch",1982,14400000,0,14400000
5689,"Trapeze",1956,14400000,0,14400000
5690,"Botoks",2017,0,14396860,14396860
5691,"Tea with Mussolini",1999,14395874,0,14395874
5692,"Remo Williams: The Adventure Begins",1985,14393902,0,14393902
5693,"Männersache",2009,0,14378901,14378901
5694,"Snow Falling on Cedars",1999,14378353,0,14378353
5695,"RBG",2018,14017361,359782,14377143
5696,"Ishtar",1987,14375181,0,14375181
5697,"City of Joy",1992,14371061,0,14371061
5698,"Ratchet and Clank",2016,8813410,5552229,14365639
5699,"The Buddy Holly Story",1978,14363400,0,14363400
5700,"Memoirs of an Invisible Man",1992,14358033,0,14358033
5701,"Friends with Kids",2012,7251073,7106679,14357752
5702,"Rapid Fire",1992,14356479,0,14356479
5703,"Excess Baggage",1997,14351432,0,14351432
5704,"Friday the 13th Part VIII: Jason Takes Manhattan",1989,14343976,0,14343976
5705,"Hot Rod",2007,13938332,396069,14334401
5706,"Dostana",2008,1235028,13097631,14332659
5707,"Surviving Christmas",2004,11198345,3130468,14328813
5708,"Turistas",2006,7027762,7293308,14321070
5709,"Tropa de Elite",2008,8744,14310451,14319195
5710,"Beginners",2011,5790894,8523513,14314407
5711,"Do You Believe?",2015,12985600,1319331,14304931
5712,"On His Majesty's Secret Service",2009,0,14303209,14303209
5713,"The Mosquito Coast",1986,14302000,0,14302000
5714,"Blue Skies",1946,14300000,0,14300000
5715,"No Manches Frida 2",2019,9177474,5122290,14299764
5716,"Grease 2",1982,14297083,0,14297083
5717,"Supergirl",1984,14296438,0,14296438
5718,"Ballistic: Ecks vs. Sever",2002,14294842,0,14294842
5719,"I Dreamed of Africa",2000,6543194,7748805,14291999
5720,"Z",1969,14283305,0,14283305
5721,"The Wizard",1989,14278900,0,14278900
5722,"Baby: Secret of the Lost Legend",1985,14276095,0,14276095
5723,"45 Years",2015,4250507,10025087,14275594
5724,"The Messenger: The Story of Joan of Arc",1999,14271297,0,14271297
5725,"Sukkar banat",2008,1060591,13193169,14253760
5726,"Josie and the Pussycats",2001,14252830,0,14252830
5727,"Freddy Got Fingered",2001,14249005,0,14249005
5728,"Unsane",2018,7690044,6554887,14244931
5729,"The Return of the Living Dead",1985,14237880,0,14237880
5730,"Mere Brother Ki Dulhan",2011,496172,13737077,14233249
5731,"Buffy the Vampire Slayer",1992,14231669,0,14231669
5732,"Bibi & Tina: Mädchen gegen Jungs",2016,0,14223864,14223864
5733,"Gambit",2012,0,14214365,14214365
5734,"Sweet Liberty",1986,14205021,0,14205021
5735,"A Chorus Line",1985,14202899,0,14202899
5736,"Scanners",1981,14200000,0,14200000
5737,"The Eiger Sanction",1975,14200000,0,14200000
5738,"Labor Day",2014,13371528,818282,14189810
5739,"Big Night",1996,12008376,2177940,14186316
5740,"Tri Bogatyrya i Printsessa Egipta",2017,0,14184772,14184772
5741,"Highlander II: The Quickening",1991,14184134,0,14184134
5742,"Prince of Darkness",1987,14182000,305,14182305
5743,"The Snows of Kilimanjaro",1952,13000000,1181330,14181330
5744,"Dirty Pretty Things",2003,8112414,6044339,14156753
5745,"Wholly Moses!",1980,14155617,0,14155617
5746,"Ernest Scared Stupid",1991,14143280,0,14143280
5747,"The Hospital",1971,14142409,0,14142409
5748,"Ya Veremos",2018,4165949,9975555,14141504
5749,"In the Land of Women",2007,11052958,3087444,14140402
5750,"Dirty Dancing Havana Nights",2004,14140215,0,14140215
5751,"Little Children",2006,5463019,8658158,14121177
5752,"Poltergeist III",1988,14114000,0,14114000
5753,"Der Nanny",2015,0,14113845,14113845
5754,"Cool World",1992,14110589,0,14110589
5755,"How to Deal",2003,14108518,0,14108518
5756,"Tomboy",1985,14100000,0,14100000
5757,"Blues Brothers 2000",1998,14089198,0,14089198
5758,"The Perfect Weapon",1991,14061361,0,14061361
5759,"Gegen die Wand",2004,435395,13625459,14060854
5760,"Fairytale: A True Story",1997,14059077,0,14059077
5761,"Traumfrauen",2015,0,14057701,14057701
5762,"Private School",1983,14049540,0,14049540
5763,"My Left Foot: The Story of Christy Brown",1989,14041353,0,14041353
5764,"Brice 3",2016,0,14039310,14039310
5765,"Shootout at Wadala",2013,369310,13669350,14038660
5766,"The Arrival",1996,14031906,0,14031906
5767,"Def Jam's How To Be a Player",1997,14010363,0,14010363
5768,"The Greek Tycoon",1978,14000000,0,14000000
5769,"The Bad News Bears Go To Japan",1978,14000000,0,14000000
5770,"The Thomas Crown Affair",1968,14000000,0,14000000
5771,"David and Bathsheba",1951,14000000,0,14000000
5772,"The Survivors",1983,14000000,0,14000000
5773,"Creepshow 2",1987,14000000,0,14000000
5774,"Un homme et une femme",1966,14000000,0,14000000
5775,"The Missouri Breaks",1976,14000000,0,14000000
5776,"The Night the Lights Went Out in Georgia",1981,14000000,0,14000000
5777,"Flowers in the Attic",1987,14000000,0,14000000
5778,"Imitation of Life",1959,14000000,0,14000000
5779,"Sharks 3D",2005,8500000,5500000,14000000
5780,"Stand and Deliver",1988,13994920,0,13994920
5781,"The Sterile Cuckoo",1969,13982357,0,13982357
5782,"Stealing Harvard",2002,13973532,0,13973532
5783,"Hong men yan",2012,0,13969132,13969132
5784,"Sesame Street Presents Follow That Bird",1985,13961370,0,13961370
5785,"The Commitments",1991,13955001,0,13955001
5786,"Los amantes pasajeros",2013,1359796,12581641,13941437
5787,"Candyman: Farewell to Flesh",1995,13916665,0,13916665
5788,"Waltz with Bashir",2008,2283849,11628440,13912289
5789,"The Children Act",2018,457803,13448329,13906132
5790,"Les Miserables",1998,13887945,0,13887945
5791,"The Missing",2017,0,13887720,13887720
5792,"Sophie Scholl - Die letzten Tage",2006,680331,13206868,13887199
5793,"Religulous",2008,13011160,870157,13881317
5794,"Shen Mo Dao Ji Gong",2017,0,13867066,13867066
5795,"House of the Dead",2003,10199354,3660724,13860078
5796,"Seven Days",2007,0,13857860,13857860
5797,"My Stepmother Is an Alien",1988,13854000,0,13854000
5798,"Smoke",1995,8353284,5500000,13853284
5799,"Hamburger Hill",1987,13839404,0,13839404
5800,"Angus, Thongs and Perfect Snogging",2009,0,13835569,13835569
5801,"Vykrutasy",2010,0,13835287,13835287
5802,"The Spanish Prisoner",1998,10162034,3673096,13835130
5803,"In the Mood for Love",2001,2734044,11100000,13834044
5804,"The Milagro Beanfield War",1988,13825794,0,13825794
5805,"Mara",2018,0,13821802,13821802
5806,"Trener",2018,0,13821097,13821097
5807,"Tri bogatyrya i Morskoy tsar",2016,0,13816096,13816096
5808,"Lord of the Flies",1990,13812230,0,13812230
5809,"The Man Who Knew Too Little",1997,13801755,0,13801755
5810,"Leave Her to Heaven",1945,13800000,0,13800000
5811,"New York, New York",1977,13800000,0,13800000
5812,"The Long Walk Home",1990,13798030,0,13798030
5813,"She's the One",1996,9482579,4312474,13795053
5814,"The Thing",1982,13782838,0,13782838
5815,"Juwanna Mann",2002,13571817,200000,13771817
5816,"Rudorufu to Ippaiattena",2016,0,13770279,13770279
5817,"Wanted",2009,349637,13404086,13753723
5818,"Io sono Tempesta",2018,0,13748817,13748817
5819,"A Kid in King Arthur's Court",1995,13406717,340562,13747279
5820,"Blow Out",1981,13747234,0,13747234
5821,"Trespass",1992,13747138,0,13747138
5822,"Drop Dead Fred",1991,13746300,0,13746300
5823,"Eighth Grade",2018,13539710,202426,13742136
5824,"Strange Magic",2015,12429583,1311760,13741343
5825,"Highlander: The Final Dimension",1995,13738574,0,13738574
5826,"Wonder Wheel",2017,1403237,12333635,13736872
5827,"Body of Evidence",1993,13734039,0,13734039
5828,"Pulling Strings",2013,5842961,7882858,13725819
5829,"One Night with the King",2006,13395961,329071,13725032
5830,"The Ladies Man",2000,13592872,126602,13719474
5831,"The Wings of the Dove",1997,13718385,0,13718385
5832,"Yolki 5",2016,0,13716383,13716383
5833,"Fear and Loathing in Las Vegas",1998,10680275,3031628,13711903
5834,"Too Young to Die",2016,0,13699654,13699654
5835,"Great Balls of Fire!",1989,13691550,0,13691550
5836,"I am a Hero",2016,0,13691149,13691149
5837,"The Sandpiper",1965,13691111,0,13691111
5838,"Return to Snowy River",1988,13687027,0,13687027
5839,"Boolhandang: Nabbeun Nomdeului Sesang",2017,0,13685342,13685342
5840,"Hey Arnold! The Movie",2002,13684949,0,13684949
5841,"Mutiny on The Bounty",1962,13680000,0,13680000
5842,"Desperate Measures",1998,13678274,0,13678274
5843,"Knight Moves",1993,923418,12744731,13668149
5844,"Vice Versa",1988,13664060,0,13664060
5845,"Chihayafuru: Musubi",2018,0,13649091,13649091
5846,"Aarakshan",2011,651096,12992412,13643508
5847,"Sydney White",2007,11892415,1743924,13636339
5848,"The Company You Keep",2012,5132442,8500007,13632449
5849,"The Crush",1993,13609396,0,13609396
5850,"Trial And Error",1997,13602831,0,13602831
5851,"American Outlaws",2001,13264986,336123,13601109
5852,"Toshokan Sensoi The Last Mission",2015,0,13597694,13597694
5853,"Osmosis Jones",2001,13596911,0,13596911
5854,"Redemption",2013,36686,13556787,13593473
5855,"Hush",1998,13587246,0,13587246
5856,"Bakuman",2015,0,13584054,13584054
5857,"Torrente 5. Operación Eurovegas",2014,0,13580332,13580332
5858,"Oneului yeonae",2015,0,13576426,13576426
5859,"Plastic Planet",2011,3164,13565535,13568699
5860,"Tomcats",2001,13558739,0,13558739
5861,"The Little Vampire",2000,13555988,0,13555988
5862,"bbaengban",2019,0,13551495,13551495
5863,"Ikari",2016,0,13540842,13540842
5864,"The Comebacks",2007,13349927,189227,13539154
5865,"Greta",2019,10519425,3000000,13519425
5866,"Hazlo Como Hombre",2017,2534252,10984231,13518483
5867,"The Deep End of the Ocean",1999,13508635,0,13508635
5868,"Nomoohyeonibnida",2017,0,13502122,13502122
5869,"Mrs. Miniver",1942,13500000,0,13500000
5870,"Africa's Elephant Kingdom",1998,13485455,0,13485455
5871,"Phantom of the Theater",2016,0,13482888,13482888
5872,"Listy do M. 2",2015,0,13482509,13482509
5873,"Le Havre",2011,611709,12868487,13480196
5874,"Charade",1963,13474588,0,13474588
5875,"Thirst",2009,318574,13150377,13468951
5876,"Los tres entierros de Melquiades Estrada",2005,5027684,8426790,13454474
5877,"The History Boys",2006,2730296,10717702,13447998
5878,"Chasseurs de dragons",2009,0,13446115,13446115
5879,"One Night at McCool's",2001,6276532,7165425,13441957
5880,"Beul-la-in-deu",2011,0,13439098,13439098
5881,"Tenacious D in: The Pick of Destiny",2006,8334575,5100000,13434575
5882,"Brideshead Revisited",2008,6432256,7000000,13432256
5883,"One Crazy Summer",1986,13431806,0,13431806
5884,"The Lords of Dogtown",2005,11273517,2150848,13424365
5885,"Extremities",1986,13418091,0,13418091
5886,"Secrets & Lies",1996,13417292,0,13417292
5887,"Tomorrow When the War Began",2012,4936,13400000,13404936
5888,"The Legend of the Lone Ranger",1981,13400000,0,13400000
5889,"Sandome no satsujin",2017,89315,13305572,13394887
5890,"Bullets Over Broadway",1994,13383747,0,13383747
5891,"Clue",1985,13377261,0,13377261
5892,"Xin Da Tou Er Zi He Xiao Tou Ba Ba Zhi Yi Ri Ch…",2016,0,13375370,13375370
5893,"Vera Drake",2004,3753806,9600049,13353855
5894,"Mr. Saturday Night",1992,13351357,0,13351357
5895,"Koneko monogatari",1989,13299749,49358,13349107
5896,"The Sons of Katie Elder",1965,13333333,0,13333333
5897,"A Stork's Journey",2017,0,13325206,13325206
5898,"Die Wilden Kerle 5",2008,0,13300000,13300000
5899,"La Cage Doree",2013,0,13300000,13300000
5900,"Bio-Dome",1996,13294762,0,13294762
5901,"The Pick-Up Artist",1987,13290368,0,13290368
5902,"North by Northwest",1959,13275000,9942,13284942
5903,"100 Dinge",2018,0,13281318,13281318
5904,"The Entity",1983,13277558,0,13277558
5905,"Lord of Illusions",1995,13249614,0,13249614
5906,"The Pirates Who Don't Do Anything: A VeggieTale…",2008,12981269,267175,13248444
5907,"In the Name of the King: A Dungeon Siege Tale",2008,4775656,8457564,13233220
5908,"One Magic Christmas",1985,13229514,0,13229514
5909,"Class Act",1992,13226469,0,13226469
5910,"Unfinished Business",2015,10219501,2994550,13214051
5911,"FearDotCom",2002,13208023,0,13208023
5912,"I Think I Love My Wife",2007,12559771,645640,13205411
5913,"Hanyo",2011,157961,13047269,13205230
5914,"Crazy People",1990,13204459,0,13204459
5915,"Anything Else",2003,3203044,10000000,13203044
5916,"Enchanted April",1992,13200170,0,13200170
5917,"Family Plot",1976,13200000,0,13200000
5918,"The Honeymooners",2005,12834849,339577,13174426
5919,"Akmareul Boatda",2011,129210,13039599,13168809
5920,"Critters",1986,13167232,0,13167232
5921,"Bai niao chao feng",2016,0,13160000,13160000
5922,"Thirst",2009,0,13158962,13158962
5923,"Dad’s Army",2016,0,13152386,13152386
5924,"Greedy",1994,13137484,0,13137484
5925,"Misz masz, czyli kogel-mogel 3",2019,0,13133367,13133367
5926,"To Kill A Mockingbird",1962,13129846,0,13129846
5927,"Bye Bye Birdie",1963,13129412,0,13129412
5928,"Nicky Larson: Le Parfum De Cupidon",2019,0,13118912,13118912
5929,"Maundy Thursday",2006,0,13117555,13117555
5930,"Author! Author!",1982,13111101,0,13111101
5931,"The Incubus",1982,13110874,0,13110874
5932,"Senseless",1998,13109234,0,13109234
5933,"Macbeth",2015,1110707,11997345,13108052
5934,"Le Jeu",2018,0,13107940,13107940
5935,"The Evil That Men Do",1984,13102025,4742,13106767
5936,"Rosewood",1997,13104494,0,13104494
5937,"Kobiety Mafii",2018,0,13100948,13100948
5938,"Hair",1979,13100000,0,13100000
5939,"Hillary’s America: The Secret History of the De…",2016,13099931,0,13099931
5940,"How to Eat Fried Worms",2006,13040527,58469,13098996
5941,"The Ice Pirates",1984,13075390,0,13075390
5942,"Saraba Abunai Deka: Long Goodbye",2016,0,13074758,13074758
5943,"The Way of the Gun",2000,6047856,7014079,13061935
5944,"Ghosts of Mississippi",1996,13052741,0,13052741
5945,"Angela's Ashes",1999,13038660,0,13038660
5946,"To Be or Not to Be",1983,13030214,0,13030214
5947,"I'm Gonna Git You Sucka",1988,13030057,0,13030057
5948,"Student of the Year",2012,326508,12702974,13029482
5949,"Crooklyn",1994,13024170,0,13024170
5950,"The Crew",2000,13019253,0,13019253
5951,"In Cold Blood",1967,13000000,7551,13007551
5952,"Da Hu Fa",2017,0,13006233,13006233
5953,"They Live",1988,13000000,774,13000774
5954,"Vision Quest",1985,13000000,0,13000000
5955,"Stroker Ace",1983,13000000,0,13000000
5956,"The Competition",1980,13000000,0,13000000
5957,"Time After Time",1979,13000000,0,13000000
5958,"The Gate",1987,13000000,0,13000000
5959,"Torn Curtain",1966,13000000,0,13000000
5960,"Hopscotch",1980,13000000,0,13000000
5961,"On the Right Track",1981,13000000,0,13000000
5962,"Rich and Famous",1981,13000000,0,13000000
5963,"The Concorde: Airport '79",1979,13000000,0,13000000
5964,"Middle Age Crazy",1980,13000000,0,13000000
5965,"Clockers",1995,12993765,0,12993765
5966,"Le Divorce",2003,9074550,3910939,12985489
5967,"Man's Best Friend",1993,12974636,0,12974636
5968,"Bandslam",2009,5210988,7756841,12967829
5969,"Roman J. Israel, Esq.",2017,11962712,1004300,12967012
5970,"Lone Star",1996,12961389,0,12961389
5971,"Sing Street",2016,3237118,9719040,12956158
5972,"Real Genius",1985,12952019,0,12952019
5973,"April Fool's Day",1986,12947763,0,12947763
5974,"The Green Inferno",2015,7192291,5739129,12931420
5975,"Slither",2006,7802450,5127893,12930343
5976,"They Call Me Bruce",1982,12925437,0,12925437
5977,"Gods and Generals",2003,12882934,41002,12923936
5978,"Die Kleine Hexe",2018,0,12923668,12923668
5979,"Hatari!",1962,12923077,0,12923077
5980,"Perfect",1985,12918858,0,12918858
5981,"Searching for Sugar Man",2012,3965090,8948401,12913491
5982,"Labyrinth",1986,12729917,182125,12912042
5983,"Los abrazos rotos",2009,5014305,7896058,12910363
5984,"Three Heroes: Horseback",2015,0,12909250,12909250
5985,"Living Out Loud",1998,12905901,0,12905901
5986,"The Other Side of the Door",2016,3000342,9904765,12905107
5987,"Seondal: The Man who Sells the River",2016,97223,12804849,12902072
5988,"Sgt. Pepper's Lonely Hearts Club Band",1978,12900000,0,12900000
5989,"Highlander",1986,5900000,7000000,12900000
5990,"Mary Reilly",1996,5707094,7192906,12900000
5991,"Loving",2016,7710234,5187830,12898064
5992,"A Far Off Place",1993,12890752,0,12890752
5993,"Evening",2007,12406646,478928,12885574
5994,"Meet Me in St. Louis",1944,12800000,82411,12882411
5995,"Welcome to Marwen",2018,10763520,2110866,12874386
5996,"Mubarakan",2017,758868,12108269,12867137
5997,"Black Dog",1998,12857351,0,12857351
5998,"Ozzy",2016,0,12852439,12852439
5999,"Deception",2008,4598506,8251527,12850033
6000,"The Grifters",1990,12850000,0,12850000
6001,"The Last Married Couple in America",1980,12835544,0,12835544
6002,"Hot Tub Time Machine 2",2015,12314651,511993,12826644
6003,"Agent Vinod",2012,698210,12124675,12822885
6004,"Mr. Wrong",1996,12805071,0,12805071
6005,"Marvin's Room",1996,12803305,0,12803305
6006,"Crayon Shin-chan Arashi wo Yobu Ougon no Spy Da…",2011,0,12801345,12801345
6007,"Highlander: Endgame",2000,12801190,0,12801190
6008,"The Nun's Story",1959,12800000,0,12800000
6009,"Urmel aus dem Eis",2006,0,12799144,12799144
6010,"Three Identical Strangers",2018,12320845,472715,12793560
6011,"Mystic Pizza",1988,12793213,0,12793213
6012,"The Associate",1996,12772657,0,12772657
6013,"The Evening Star",1996,12767815,0,12767815
6014,"L'élève Ducobu",2011,0,12767508,12767508
6015,"Aliens of the Deep",2005,8968684,3797000,12765684
6016,"Gekijoban Mahou Shojo Madoka Magica Shinpen Han…",2013,190478,12571570,12762048
6017,"Hotel Artemis",2018,6708137,6050662,12758799
6018,"Weekend at Bernie's II",1993,12741891,0,12741891
6019,"Bon Cop, Bad Cop",2006,12671300,69405,12740705
6020,"Come September",1961,12710696,0,12710696
6021,"D.O.A.",1988,12706478,0,12706478
6022,"Come Blow Your Horn",1963,12705882,0,12705882
6023,"Move Over, Darling",1963,12705882,0,12705882
6024,"Paris Can Wait",2017,5608745,7078745,12687490
6025,"The Omega Code",1999,12610552,67760,12678312
6026,"Idlewild",2006,12669914,0,12669914
6027,"Street Fighter: The Legend of Chun-Li",2009,8742261,3918026,12660287
6028,"Chasing Papi",2003,6126237,6531140,12657377
6029,"Last Night",2011,112087,12534432,12646519
6030,"Kiseijuu: Kanketsuhen",2015,0,12640766,12640766
6031,"The Bedroom Window",1987,12640385,0,12640385
6032,"Everybody’s All-American",1988,12638294,0,12638294
6033,"Bad Influence",1990,12626043,0,12626043
6034,"Extreme Ops",2002,4835968,7788503,12624471
6035,"People Like Us",2012,12431792,185680,12617472
6036,"Frenzy",1972,12600000,0,12600000
6037,"They Shoot Horses, Don't They?",1969,12600000,0,12600000
6038,"Diner",1982,12592907,0,12592907
6039,"The Spitfire Grill",1996,12592203,0,12592203
6040,"A Love",2007,0,12592135,12592135
6041,"Gossip",2000,5108820,7482450,12591270
6042,"Visiting Hours",1982,12581713,0,12581713
6043,"Bachelorette",2012,446770,12130631,12577401
6044,"Love Jones",1997,12554569,0,12554569
6045,"Jim Knopf und Lukas der Lokomotivführer",2018,0,12535573,12535573
6046,"Gattaca",1997,12532777,0,12532777
6047,"Hellraiser III: Hell on Earth",1992,12525537,0,12525537
6048,"The Suspect",2013,0,12525348,12525348
6049,"War and Peace",1956,12500000,24028,12524028
6050,"Sorority Boys",2002,10198766,2317456,12516222
6051,"Klute",1971,12512637,0,12512637
6052,"Breakin' All the Rules",2004,12232382,279935,12512317
6053,"Why Do Fools Fall In Love?",1998,12506676,0,12506676
6054,"Zoom",2006,11989328,516860,12506188
6055,"Father Goose",1964,12500000,0,12500000
6056,"The Song of Bernadette",1943,12500000,0,12500000
6057,"Sous les jupes des filles",2014,0,12499035,12499035
6058,"Meri Pyaari Bindu",2017,0,12498298,12498298
6059,"PMC: deo beong-keo",2018,0,12478635,12478635
6060,"Kamen Raidâ Heisei Jenerêshonzu Foebâ",2018,0,12465928,12465928
6061,"Beautiful Boy",2018,7634767,4827943,12462710
6062,"Elle",2016,2339735,10115810,12455545
6063,"The Marrying Man",1991,12454768,0,12454768
6064,"Gekijouban Fate/Stay Night: Heaven's Feel - II.…",2019,0,12451537,12451537
6065,"Material Girls",2006,11449638,1000000,12449638
6066,"Kai Po Che",2013,1122527,11310288,12432815
6067,"Boy s tenyu 2",2007,0,12426015,12426015
6068,"The Fourth Protocol",1987,12423831,0,12423831
6069,"Knockaround Guys",2002,11660180,759520,12419700
6070,"Undercover Blues",1993,12416686,0,12416686
6071,"Bad Lieutenant: Port of Call New Orleans",2009,1702112,10711837,12413949
6072,"Nueve Reinas",2002,1222889,11190000,12412889
6073,"Monsignor",1982,12408066,0,12408066
6074,"The Bling Ring",2013,5845732,6561759,12407491
6075,"Bella",2007,8093373,4312100,12405473
6076,"MBA Partners",2016,0,12403537,12403537
6077,"Irreconcilable Differences",1984,12400000,0,12400000
6078,"Mambo Italiano",2003,9282750,3117022,12399772
6079,"Undisputed",2002,12398628,0,12398628
6080,"I’m Not There",2007,4017609,8380004,12397613
6081,"Less than Zero",1987,12396383,0,12396383
6082,"Promised Land",2013,7597898,4796664,12394562
6083,"The Man Who Knew Infinity",2016,3877922,8504200,12382122
6084,"Shaolin Girl",2008,0,12380512,12380512
6085,"Their Finest",2017,3603484,8773777,12377261
6086,"The Andromeda Strain",1971,12376563,0,12376563
6087,"Ready to Rumble",2000,12372410,0,12372410
6088,"A Shot in the Dark",1964,12368234,0,12368234
6089,"Life With Mikey",1993,12349549,0,12349549
6090,"Soul Men",2008,12082391,263492,12345883
6091,"The Interview",2014,6105175,6237457,12342632
6092,"Millions",2005,6584159,5753669,12337828
6093,"The Ref",1994,11325885,1000000,12325885
6094,"Eye for an Eye",2008,0,12314832,12314832
6095,"Gu Dao Jing Hun",2011,0,12312603,12312603
6096,"True Romance",1993,12281000,28980,12309980
6097,"Club Paradise",1986,12308521,0,12308521
6098,"Hotel Mumbai",2019,8908015,3398662,12306677
6099,"No Mercy",1986,12303904,0,12303904
6100,"Enemy Mine",1985,12303411,0,12303411
6101,"Escape from the Planet of the Apes",1971,12300000,0,12300000
6102,"Chasing Liberty",2004,12189514,102461,12291975
6103,"A Stranger Among Us",1992,12282994,0,12282994
6104,"Casual Sex?",1988,12277096,0,12277096
6105,"Titeuf, Le Film",2011,0,12268517,12268517
6106,"My Life Without Me",2003,432360,11834915,12267275
6107,"Dark Blue",2003,9237470,3024595,12262065
6108,"Whiteout",2009,10275638,1979108,12254746
6109,"Lejdis",2008,0,12247829,12247829
6110,"Låt den rätte komma in",2008,2122085,10125597,12247682
6111,"Nuovo cinema Paradiso",1990,11985152,251878,12237030
6112,"Lone Wolf McQuade",1983,12232628,0,12232628
6113,"The Lunchbox",2014,4231500,8000000,12231500
6114,"Abandon",2002,10719367,1500000,12219367
6115,"I'll Be Home For Christmas",1998,12214338,0,12214338
6116,"El Secreto de Marrowbone",2017,1377,12211460,12212837
6117,"Confidence",2003,12212417,0,12212417
6118,"Back to the Beach",1987,12208754,0,12208754
6119,"Hideaway",1995,12201255,0,12201255
6120,"True Confessions",1981,12200000,0,12200000
6121,"Earth: One Amazing Day",2017,81345,12117026,12198371
6122,"No One’s Life Is Easy: So I Married an Anti-Fan",2016,89408,12104668,12194076
6123,"Office Space",1999,10827813,1351895,12179708
6124,"Gold",2017,7227038,4951070,12178108
6125,"Trumbo",2015,7857741,4315682,12173423
6126,"Kalank",2019,1763185,10400000,12163185
6127,"Babies",2010,7320323,4826496,12146819
6128,"Pink Cadillac",1989,12143484,0,12143484
6129,"Le Coeur des hommes 2",2007,0,12130156,12130156
6130,"Little Big League",1994,12124754,0,12124754
6131,"Shaft",1971,12121618,0,12121618
6132,"Chihayafuru Kaminoku",2016,0,12116649,12116649
6133,"Mongtajoo",2013,0,12116647,12116647
6134,"Dreamscape",1984,12116365,0,12116365
6135,"Judgment Night",1993,12108480,0,12108480
6136,"Crystal Sky Of Yesterday",2018,0,12104007,12104007
6137,"Roommates",1995,12076989,0,12076989
6138,"Bye Bye Love",1995,12073560,0,12073560
6139,"Holy Man",1998,12069719,0,12069719
6140,"Help!",1965,12066667,0,12066667
6141,"She's Out of Control",1989,12065892,0,12065892
6142,"The King and I",1999,12064440,0,12064440
6143,"Dave Chappelle's Block Party",2006,11718595,333329,12051924
6144,"Fatal Beauty",1987,12046526,0,12046526
6145,"The Pagemaster",1994,12039526,0,12039526
6146,"Stoker",2013,1703125,10331788,12034913
6147,"McDull, Kung Fu Kindergarten",2009,0,12031621,12031621
6148,"How to Lose Friends & Alienate People",2008,2775593,9255850,12031443
6149,"Harry Brown",2010,1818681,10204925,12023606
6150,"Suburbicon",2017,5775178,6246328,12021506
6151,"Yi Nian Tian Tang",2016,0,12020000,12020000
6152,"In Dreams",1999,12017369,0,12017369
6153,"Sorcerer",1977,12000000,5968,12005968
6154,"The Tall Men",1955,12000000,3399,12003399
6155,"Fantastic Voyage",1966,12000000,0,12000000
6156,"The Postman Always Rings Twice",1946,12000000,0,12000000
6157,"The Big Fix",1978,12000000,0,12000000
6158,"The Changeling",1980,12000000,0,12000000
6159,"Divorce American Style",1967,12000000,0,12000000
6160,"First Monday in October",1981,12000000,0,12000000
6161,"The Frisco Kid",1979,12000000,0,12000000
6162,"Bandolero!",1968,12000000,0,12000000
6163,"Harper",1966,12000000,0,12000000
6164,"Hombre",1967,12000000,0,12000000
6165,"The Sea Chase",1955,12000000,0,12000000
6166,"Gentlemen Prefer Blondes",1953,12000000,0,12000000
6167,"Race with the Devil",1975,12000000,0,12000000
6168,"Physical Evidence",1989,12000000,0,12000000
6169,"Tall Story",1960,12000000,0,12000000
6170,"The Other Side of the Mountain Part II",1978,12000000,0,12000000
6171,"How to Murder Your Wife",1965,12000000,0,12000000
6172,"Frankenstein",1931,12000000,0,12000000
6173,"French Connection II",1975,12000000,0,12000000
6174,"Cape No. 7",2008,0,12000000,12000000
6175,"De Dana Dan",2009,944979,11053270,11998249
6176,"Warum Männer nicht zuhören und Frauen schlecht …",2007,0,11996501,11996501
6177,"4 luni, 3 saptamani si 2 zile",2008,1196321,10796835,11993156
6178,"Sluzhebnyy roman. Nashye vryemya",2011,0,11990788,11990788
6179,"Rudo y Cursi",2009,1827660,10160264,11987924
6180,"Outrage Coda",2017,0,11983269,11983269
6181,"Carrossel 2: O Sumiço de Maria Joaquina",2016,0,11972853,11972853
6182,"The Great Escape",1963,11744471,228090,11972561
6183,"Brighton Beach Memoirs",1986,11957943,0,11957943
6184,"Jûni-nin no shinitai kodomo-tachi",2019,0,11950916,11950916
6185,"Mirreyes contra Godinez",2019,0,11949192,11949192
6186,"City Hunter: Shinjuku Private Eyes",2019,0,11949165,11949165
6187,"Diana",2013,335360,11611623,11946983
6188,"La French",2014,190980,11753086,11944066
6189,"Changgwol",2018,167937,11769738,11937675
6190,"End of the Spear",2006,11748661,175380,11924041
6191,"Duong Gia Tuong",2013,0,11906509,11906509
6192,"Viceroy’s House",2017,1105717,10800074,11905791
6193,"Xiao men shen",2016,0,11902156,11902156
6194,"Making Love",1982,11897978,0,11897978
6195,"Katyn",2009,118095,11764195,11882290
6196,"The Way",2011,4430650,7451541,11882191
6197,"Sungnan Hwangso",2018,101417,11770583,11872000
6198,"Win Win",2011,10179275,1689788,11869063
6199,"Kal Ho Naa Ho",2003,1956478,9905557,11862035
6200,"Action Replayy",2010,410262,11446966,11857228
6201,"A Hologram for the King",2016,4212494,7633516,11846010
6202,"Narc",2002,10465659,1377601,11843260
6203,"Don't Move",2005,103280,11734323,11837603
6204,"Firewalker",1986,11834302,0,11834302
6205,"Chloe",2010,3075255,8755876,11831131
6206,"Ni Hao, Zhi Hua",2018,179721,11648683,11828404
6207,"Conviction",2010,6797696,5029284,11826980
6208,"Year of the Gun",1991,11820000,0,11820000
6209,"Getaway",2013,10501938,1312051,11813989
6210,"The Thirteenth Floor",1999,11810854,0,11810854
6211,"Back Roads",1981,11809387,0,11809387
6212,"Bloodsport",1988,11806119,0,11806119
6213,"Yankee Doodle Dandy",1942,11800000,0,11800000
6214,"The Rules of Attraction",2002,6525762,5273298,11799060
6215,"Zelig",1983,11798616,0,11798616
6216,"Caddyshack II",1988,11798302,0,11798302
6217,"The Belko Experiment",2017,10166820,1626122,11792942
6218,"This Must Be the Place",2012,142242,11649818,11792060
6219,"Le chant du loup",2019,0,11789304,11789304
6220,"Tales from the Hood",1995,11784569,0,11784569
6221,"Saekjeuk shigong 2",2007,0,11780198,11780198
6222,"The Thrill of it All",1963,11779093,0,11779093
6223,"The Longshots",2008,11511323,267073,11778396
6224,"Kureyon Shinchan: Arashi o Yobu: Utau Ketsudake…",2006,0,11777171,11777171
6225,"Hoop Dreams",1994,7768371,4000000,11768371
6226,"Seeking a Friend for the End of the World",2012,7078738,4688221,11766959
6227,"Shopgirl",2005,10284523,1473895,11758418
6228,"Myûjiamu",2016,0,11757642,11757642
6229,"Ryûzô to 7 nin no kobun tachi",2015,0,11757243,11757243
6230,"Micmacs",2010,1259693,10497229,11756922
6231,"Gunfight at the O.K. Corral",1957,11750000,0,11750000
6232,"A Casa Tutti Bene",2018,0,11746742,11746742
6233,"Layer Cake",2005,2339957,9405974,11745931
6234,"3 Ninjas Kick Back",1994,11744960,0,11744960
6235,"Ca$h",2008,0,11738256,11738256
6236,"Strictly Ballroom",1993,11738000,0,11738000
6237,"Can You Ever Forgive Me?",2018,8803865,2933314,11737179
6238,"Quills",2000,7060876,4671212,11732088
6239,"Dhoom 3",2013,8031955,3691665,11723620
6240,"The Lords of Discipline",1983,11721041,0,11721041
6241,"The Visit",2000,186444,11529548,11715992
6242,"Used Cars",1980,11715321,0,11715321
6243,"The Son's Room",2002,1014416,10700000,11714416
6244,"Up the Creek",1984,11708269,0,11708269
6245,"Tik Tok",2016,0,11702016,11702016
6246,"Nae sarang nae gyeotae",2009,0,11701551,11701551
6247,"C'est Si Bon",2015,164167,11537018,11701185
6248,"Beauty and the Beast",2010,0,11700000,11700000
6249,"Mary Magdalene",2018,114497,11585369,11699866
6250,"Çakallarla Dans 5",2018,0,11687785,11687785
6251,"Island of Lemurs: Madagascar",2014,11246554,419850,11666404
6252,"Rock-a-Doodle",1992,11657385,0,11657385
6253,"Smart People",2008,9511289,2144330,11655619
6254,"Halloween 5: The Revenge of Michael Myers",1989,11642254,0,11642254
6255,"What a Man",2012,0,11639918,11639918
6256,"Bokudake ga inai machi",2016,0,11636849,11636849
6257,"Khatta Meetha",2010,541904,11093357,11635261
6258,"The Adventures of Elmo in Grouchland",1999,11634458,0,11634458
6259,"Dum Maaro Dum",2011,564489,11068938,11633427
6260,"Fala Sério, Mãe!",2017,0,11616161,11616161
6261,"The Muse",1999,11614954,0,11614954
6262,"The Last Kiss",2006,11614790,0,11614790
6263,"Taare Zameen Par",2007,1223869,10389309,11613178
6264,"Hellraiser II: Hellbound",1988,11611883,0,11611883
6265,"Faubourg 36",2009,850575,10760000,11610575
6266,"Bogowie",2014,0,11603941,11603941
6267,"Lifeforce",1985,11603545,0,11603545
6268,"Wara No Tate",2013,0,11601232,11601232
6269,"Finian’s Rainbow",1968,11600000,0,11600000
6270,"Banlieue 13",2006,1200216,10399687,11599903
6271,"So I Married an Axe Murderer",1993,11585483,0,11585483
6272,"Graveyard Shift",1990,11578883,0,11578883
6273,"Wing Commander",1999,11578022,0,11578022
6274,"Wu Lin Guai Shou",2018,0,11573104,11573104
6275,"Police Academy 6: City Under Siege",1989,11567000,0,11567000
6276,"Iron Sky",2012,122082,11443710,11565792
6277,"The Order",2003,7659747,3900000,11559747
6278,"The Legend of Drunken Master",2000,11546543,0,11546543
6279,"Cinderella and The Secret Prince",2018,0,11541841,11541841
6280,"Pump Up the Volume",1990,11541758,0,11541758
6281,"The Cookout",2004,11540112,0,11540112
6282,"Tsotsi",2006,2912606,8624933,11537539
6283,"Young Einstein",1989,11536599,0,11536599
6284,"Bhoothnath",2008,449776,11083019,11532795
6285,"Turbulence",1997,11532774,0,11532774
6286,"Doroppu",2009,0,11528993,11528993
6287,"Shattered",1991,11511031,0,11511031
6288,"Alaska",1996,11509600,0,11509600
6289,"Mulholland Falls",1996,11504190,0,11504190
6290,"Galapagos",1955,11500000,0,11500000
6291,"Yolki Posledniye",2018,0,11499494,11499494
6292,"The Sessions",2012,6002451,5492753,11495204
6293,"Nativity 3: Dude, Where's My Donkey?",2014,0,11492347,11492347
6294,"Zhi Wo Men Zhong Jiang Dao Lai De Ai Qing",2016,0,11487632,11487632
6295,"The Beautician and the Beast",1997,11486880,0,11486880
6296,"Something New",2006,11468568,15101,11483669
6297,"99 francs",2008,79477,11400000,11479477
6298,"Teen Maar",2011,0,11459148,11459148
6299,"Elegy",2008,3577210,7881829,11459039
6300,"Shigatsu wa kimi no uso",2016,0,11444510,11444510
6301,"Moon Over Parador",1988,11444204,0,11444204
6302,"Jiang hu er nv",2018,352640,11090748,11443388
6303,"Perdiendo el norte",2015,0,11438207,11438207
6304,"The Birds",1963,11403529,32655,11436184
6305,"Beyond Borders",2003,4426297,7000793,11427090
6306,"Sphinx",1981,2000000,9400000,11400000
6307,"Boy Erased",2018,6788692,4600000,11388692
6308,"Thaanaa Serndha Koottam",2018,0,11383175,11383175
6309,"Far from Home: The Adventures of Yellow Dog",1995,11380788,0,11380788
6310,"Dag 2",2016,0,11378898,11378898
6311,"Just One of the Guys",1985,11377655,0,11377655
6312,"Thumbelina",1994,11373501,0,11373501
6313,"Serenity",2019,8547045,2819984,11367029
6314,"Doeorak",2018,0,11366235,11366235
6315,"Cops and Robbersons",1994,11363618,0,11363618
6316,"Hui Buh - Das Schlossgespenst",2006,0,11361720,11361720
6317,"Shut In",2016,6900335,4460330,11360665
6318,"Opportunity Knocks",1990,11359129,0,11359129
6319,"Reign of Assassins",2012,0,11354230,11354230
6320,"Snow Flower and the Secret Fan",2011,1348205,10000000,11348205
6321,"Gross Anatomy",1989,11346186,0,11346186
6322,"50 Kaime no Fasuto Kisu",2018,0,11342404,11342404
6323,"Hexe Lilli, der Drache und das magische Buch",2009,0,11338495,11338495
6324,"The Man Who Knew Too Much",1956,11333333,0,11333333
6325,"Manhattan Murder Mystery",1993,11330911,0,11330911
6326,"Double Team",1997,11328565,0,11328565
6327,"Amityville II: The Possession",1982,11328000,0,11328000
6328,"Beyaz Melek",2007,0,11323769,11323769
6329,"Water",2006,5529144,5793429,11322573
6330,"American Me",1992,11318100,0,11318100
6331,"Friend Request",2016,3759078,7551757,11310835
6332,"Extreme Prejudice",1987,11307844,0,11307844
6333,"Leave It To Beaver",1997,11307615,0,11307615
6334,"Spanish Movie",2012,0,11305452,11305452
6335,"Toni Erdmann",2016,1478960,9821464,11300424
6336,"Who's the Man?",1993,11299730,0,11299730
6337,"The Florida Project",2017,5904366,5390958,11295324
6338,"Toshokan Senso",2013,0,11294442,11294442
6339,"La fille du puisatier",2012,389651,10894695,11284346
6340,"Jennifer Eight",1992,11281492,0,11281492
6341,"Cìkè Niè Yinniáng",2015,632542,10647342,11279884
6342,"Les As de la Jungle",2017,0,11277610,11277610
6343,"Lars and the Real Girl",2007,5956480,5320639,11277119
6344,"One Good Cop",1991,11276846,0,11276846
6345,"Balto",1995,11268750,0,11268750
6346,"Chill Factor",1999,11263966,0,11263966
6347,"Son of Rambow: A Home Movie",2008,1785505,9477758,11263263
6348,"Frances Ha",2013,4067398,7195371,11262769
6349,"Straw Dogs",2011,10324441,929380,11253821
6350,"Roving Mars",2006,10407978,841000,11248978
6351,"The King’s Case Note",2017,90899,11155025,11245924
6352,"Cyberworld 3D",2000,11243857,0,11243857
6353,"Hyde Park on Hudson",2012,6376145,4866293,11242438
6354,"Taxi",2015,321642,10913305,11234947
6355,"La flûte à six schtroumpfs",1983,11234220,0,11234220
6356,"Stop-Loss",2008,10915744,313291,11229035
6357,"Superman IV: The Quest for Peace",1987,11227824,0,11227824
6358,"Before Sunset",2004,5792822,5424524,11217346
6359,"Unfinished Song",2013,1698952,9511765,11210717
6360,"La Graine et le Mulet",2008,203490,11004374,11207864
6361,"Q & A",1990,11207000,0,11207000
6362,"Deep Rising",1998,11203026,0,11203026
6363,"Es Por Tu Bien",2017,0,11202953,11202953
6364,"Assalto ao Banco Central",2011,0,11200000,11200000
6365,"The Squid and the Whale",2005,7372734,3818689,11191423
6366,"Kiseki: Anohi no sobito",2017,0,11182550,11182550
6367,"What a Way to Go!",1964,11180531,0,11180531
6368,"Jab Harry Met Sejal",2017,1284740,9891804,11176544
6369,"Never Let Me Go",2010,2434652,8739066,11173718
6370,"Daeho",2015,0,11172111,11172111
6371,"King Solomon's Mines",1950,11172000,0,11172000
6372,"The Cardinal",1963,11170588,0,11170588
6373,"Xin Yong Bu Xiao Shi De Dian Bo",2017,0,11170000,11170000
6374,"Fun Size ",2012,9409538,1757077,11166615
6375,"Agnyaathavaasi",2018,0,11158499,11158499
6376,"Barney's Great Adventure",1998,11156471,0,11156471
6377,"Les Gamins",2013,0,11146589,11146589
6378,"The Astronaut Farmer",2007,11003643,137570,11141213
6379,"The Sisters Brothers",2018,3143056,7994796,11137852
6380,"Tank",1984,11131530,0,11131530
6381,"The Cooler",2003,8291572,2839883,11131455
6382,"V.I. Warshawski",1991,11128309,0,11128309
6383,"Whispers in the Dark",1992,11124511,0,11124511
6384,"Brokedown Palace",1999,10115014,1000752,11115766
6385,"The Adventure of Afanti",2018,0,11113411,11113411
6386,"Zhan Guo",2011,68961,11042800,11111761
6387,"Samba",2014,151530,10955865,11107395
6388,"2 Days In The Valley",1996,11101856,0,11101856
6389,"Please Don't Eat the Daisies",1960,11100000,0,11100000
6390,"Big Trouble in Little China",1986,11100000,0,11100000
6391,"A United Kingdom",2016,3902185,7193835,11096020
6392,"My Family",1995,11079373,0,11079373
6393,"Yuen Loeng Taa 77 Chi",2017,0,11077852,11077852
6394,"Gypsy",1962,11076923,0,11076923
6395,"The Unsinkable Molly Brown",1964,11070559,0,11070559
6396,"L'Ora Legale",2017,0,11066825,11066825
6397,"Tokyo Tower: Mom and Me and Sometimes Dad",2007,0,11061179,11061179
6398,"The Adventures of Priscilla, Queen of the Desert",1994,11059000,0,11059000
6399,"Family Business",1989,11053835,0,11053835
6400,"Les Saisons",2016,150092,10903563,11053655
6401,"Krush Groove",1985,11052713,0,11052713
6402,"Aashiqui 2",2013,0,11046634,11046634
6403,"La Boda de Valentina",2018,2783739,8261970,11045709
6404,"Xue Zhan Xiang Jiang",2017,0,11037772,11037772
6405,"Come Un Gatto in Tangenziale",2017,0,11024178,11024178
6406,"Jonah Hex",2010,10547117,475579,11022696
6407,"A Farewell To Arms",1957,11000000,17403,11017403
6408,"Solomon and Sheba",1959,11000000,14961,11014961
6409,"The Couch Trip",1988,11005304,0,11005304
6410,"The Super",1991,11000863,0,11000863
6411,"Tom Sawyer",1930,11000000,0,11000000
6412,"Wild Orchid",1990,11000000,0,11000000
6413,"On the Beach",1959,11000000,0,11000000
6414,"Bite the Bullet",1975,11000000,0,11000000
6415,"Cold Turkey",1971,11000000,0,11000000
6416,"The Last Flight of Noah’s Ark",1980,11000000,0,11000000
6417,"Show Boat",1951,11000000,0,11000000
6418,"It's My Turn",1980,11000000,0,11000000
6419,"A Hole in the Head",1959,11000000,0,11000000
6420,"The Lost Weekend",1945,11000000,0,11000000
6421,"Wolfen",1981,11000000,0,11000000
6422,"In Like Flint",1967,11000000,0,11000000
6423,"Raggedy Man",1981,11000000,0,11000000
6424,"Gator",1976,11000000,0,11000000
6425,"The Mirror Crack'd",1980,11000000,0,11000000
6426,"The Golden Voyage of Sinbad",1974,11000000,0,11000000
6427,"The Man Who Loved Women",1983,11000000,0,11000000
6428,"Hangar 18",1980,11000000,0,11000000
6429,"The Birth of a Nation",1915,10000000,1000000,11000000
6430,"Pat Garrett and Billy the Kid",1973,8000000,3000000,11000000
6431,"American Hot Wax",1978,11000000,0,11000000
6432,"Ya Khudeyu",2018,0,10999308,10999308
6433,"Career Opportunities",1991,10986645,0,10986645
6434,"Who's Harry Crumb?",1989,10982364,0,10982364
6435,"Nuns on the Run",1990,10959015,0,10959015
6436,"High & Low The Movie 2 / End of Sky",2017,0,10956658,10956658
6437,"Black Snake Moan",2007,9396870,1554283,10951153
6438,"Qian Ting Zong Dong Yuan: Hai Di Liang Wan Li",2018,0,10949902,10949902
6439,"What the #$'! Do We Know",2004,10941801,0,10941801
6440,"Seuwingkizeu",2018,222001,10710030,10932031
6441,"Le pacte des loups",2001,10928863,0,10928863
6442,"Senna",2011,1612430,9312217,10924647
6443,"Cookie's Fortune",1999,10920544,0,10920544
6444,"Rapurasu no majo",2018,0,10919843,10919843
6445,"Garfield's Pet Force",2009,0,10918505,10918505
6446,"Buradeo",2017,0,10910056,10910056
6447,"Le brio",2017,0,10906284,10906284
6448,"The Englishman Who Went Up a Hill, But Came Dow…",1995,10904930,0,10904930
6449,"Kismat Konnection",2008,479759,10424168,10903927
6450,"The Darkness",2016,10753574,144719,10898293
6451,"Flying Monsters 3D",2011,5751141,5143082,10894223
6452,"The Pink Panther",1964,10878107,0,10878107
6453,"The Man in the Gray Flannel Suit",1956,10875000,0,10875000
6454,"Narrow Margin",1990,10873237,0,10873237
6455,"Himmatwala",2013,270880,10600990,10871870
6456,"Jannat 2",2012,0,10858608,10858608
6457,"Extract",2009,10823158,26000,10849158
6458,"Hei Mao Jing Zhang Zhi Fei Cui Zhi Xing",2015,0,10849131,10849131
6459,"Vai que Cola: O Filme",2015,0,10845468,10845468
6460,"Here on Earth",2000,10494147,350980,10845127
6461,"Xiao shi de xiong shou",2015,0,10844564,10844564
6462,"The Hole",2001,0,10834406,10834406
6463,"Maya the Bee",2014,0,10833134,10833134
6464,"Samyy luchshiy film 3",2010,0,10832328,10832328
6465,"Samyy luchshiy den!",2015,0,10828870,10828870
6466,"Get Low",2010,9176933,1651372,10828305
6467,"You Can Count on Me",2000,9180275,1647081,10827356
6468,"Luo Ke Wang Guo 4",2015,0,10820000,10820000
6469,"Moving",1988,10815378,0,10815378
6470,"Silver Bullet",1985,10803211,0,10803211
6471,"Un Sac De Billes",2017,409862,10381751,10791613
6472,"Away From Her",2007,4548331,6239159,10787490
6473,"The Night Listener",2006,7836393,2934600,10770993
6474,"It’s a Wonderful Life",1946,6600000,4168908,10768908
6475,"We Need to Talk About Kevin",2012,1738692,9026591,10765283
6476,"New York Stories",1989,10763469,0,10763469
6477,"Prom",2011,10130219,632964,10763183
6478,"Missing in Action 2: The Beginning",1985,10755447,0,10755447
6479,"The Beastmaster",1982,10751126,0,10751126
6480,"The African Queen",1951,10750000,0,10750000
6481,"Villaviciosa de al lado",2016,0,10739182,10739182
6482,"Mister Felicità",2017,0,10739001,10739001
6483,"Flower Drum Song",1961,10738117,0,10738117
6484,"Stay Tuned",1992,10736401,0,10736401
6485,"Ajin",2017,0,10735896,10735896
6486,"Not Easily Broken",2009,10572742,160167,10732909
6487,"Gettysburg",1993,10731997,0,10731997
6488,"Yolki 1914",2014,0,10727769,10727769
6489,"Paterson",2016,2141423,8586113,10727536
6490,"Glengarry Glen Ross",1992,10725228,0,10725228
6491,"Golden Slumber",2018,0,10723414,10723414
6492,"Universal Soldier II: The Return",1999,10447421,270000,10717421
6493,"For Love or Money",1993,10709430,0,10709430
6494,"Pure Country",1992,10705365,0,10705365
6495,"The Fiendish Plot of Dr. Fu Manchu",1980,10697276,0,10697276
6496,"RoboCop 3",1993,10696210,0,10696210
6497,"Mad Dog and Glory",1993,10688490,0,10688490
6498,"Make It Happen",2008,0,10688486,10688486
6499,"Deconstructing Harry",1997,10686841,0,10686841
6500,"Mogura no uta: Hong Kong kyôsô-kyoku",2016,0,10677009,10677009
6501,"Moon",2009,5010163,5665910,10676073
6502,"The Astronaut's Wife",1999,10672566,0,10672566
6503,"Ghost Dog: The Way of the Samurai",2000,3330230,7342262,10672492
6504,"Shinjuku suwan",2015,0,10662923,10662923
6505,"Dracula: Dead and Loving It",1995,10660264,0,10660264
6506,"The End of the Affair",1999,10660147,0,10660147
6507,"Rab Ne Bana Di Jodi",2008,2074346,8585000,10659346
6508,"Di san zhong ai qing",2015,0,10659259,10659259
6509,"Island of the Sharks",1999,10658756,0,10658756
6510,"Xie Mi Xing Zhe",2018,0,10657326,10657326
6511,"The Package",1989,10647219,0,10647219
6512,"De père en flic",2009,10644453,0,10644453
6513,"The Savages",2007,6623082,4018941,10642023
6514,"Ookami shoujo to kuro ouji",2016,0,10639039,10639039
6515,"A Dirty Carnival",2006,0,10638098,10638098
6516,"The Apparition",2012,4936819,5700462,10637281
6517,"The Purple Rose of Cairo",1985,10631333,0,10631333
6518,"The Boondock Saints 2: All Saints Day",2009,10273187,356133,10629320
6519,"Tengoku de kimi ni aetara",2007,0,10625731,10625731
6520,"The Virgin Suicides",2000,4859475,5760295,10619770
6521,"Return to Oz",1985,10618813,0,10618813
6522,"Populaire",2012,179091,10438198,10617289
6523,"Pek Yakinda",2014,0,10611890,10611890
6524,"Happy Birthday To Me",1981,10609514,0,10609514
6525,"After Hours",1985,10609321,0,10609321
6526,"Broadway Danny Rose",1984,10600497,0,10600497
6527,"Le Week-End",2013,2225098,8374932,10600030
6528,"Compromising Positions",1985,10600000,0,10600000
6529,"Moving Violations",1985,10600000,0,10600000
6530,"Falling in Love",1984,10600000,0,10600000
6531,"Play Misty for Me",1971,10600000,0,10600000
6532,"Benedetta Follia",2018,0,10599900,10599900
6533,"Kabadayi",2007,0,10599297,10599297
6534,"Liteul Poleseuteu",2018,0,10598724,10598724
6535,"The Great Raid",2005,10166502,430568,10597070
6536,"Alone in the Dark",2005,5178569,5409510,10588079
6537,"Cha-i-na-ta-un",2015,0,10582907,10582907
6538,"Drop Dead Gorgeous",1999,10571408,0,10571408
6539,"Three to Tango",1999,10570375,0,10570375
6540,"Alceste a bicyclette",2013,385165,10183850,10569015
6541,"Mad City",1997,10561038,0,10561038
6542,"Looking for Eric",2010,55804,10504168,10559972
6543,"Pollock",2000,8596914,1960377,10557291
6544,"Husbands and Wives",1992,10555619,0,10555619
6545,"We're No Angels",1989,10555348,0,10555348
6546,"The Promise",2017,8224288,2327129,10551417
6547,"Moms’ Night Out",2014,10429707,107634,10537341
6548,"Les Tuche",2010,0,10537035,10537035
6549,"Crayon Shin-chan 16",2008,0,10536987,10536987
6550,"Where the Boys Are '84",1984,10530000,0,10530000
6551,"Beautiful Girls",1996,10523880,0,10523880
6552,"Love in Space",2011,33976,10485987,10519963
6553,"Home Fries",1998,10513979,0,10513979
6554,"Deo Pon",2015,0,10510802,10510802
6555,"Gosaigyô no Onna",2016,0,10504345,10504345
6556,"Até que a Sorte nos Separe 3: A Falência Final",2015,0,10502937,10502937
6557,"American Ninja",1985,10499000,0,10499000
6558,"Baadshaho",2017,0,10497601,10497601
6559,"Two if by Sea",1996,10493670,0,10493670
6560,"Silent Rage",1982,10490791,0,10490791
6561,"Light of Day",1987,10489617,0,10489617
6562,"The Collector",2009,7712114,2761722,10473836
6563,"Teri Meri Kahaani",2012,671442,9800286,10471728
6564,"Steamboy",2005,468867,10000000,10468867
6565,"El Angel",2018,109608,10355442,10465050
6566,"Casablanca",1943,10462500,2121,10464621
6567,"Operation Condor",1997,10461161,0,10461161
6568,"On-Drakon",2015,0,10453051,10453051
6569,"Dangerous Liaisons",2012,17000,10430579,10447579
6570,"Luis Und Die Aliens",2018,0,10444253,10444253
6571,"Camp Nowhere",1994,10442641,0,10442641
6572,"Blue Hawaii",1961,10440453,0,10440453
6573,"Lyubov v bolshom gorode",2009,0,10439457,10439457
6574,"A Rage in Harlem",1991,10438504,0,10438504
6575,"Interiors",1978,10432366,0,10432366
6576,"LOL",2012,0,10431506,10431506
6577,"The Brothers McMullen",1995,10426506,0,10426506
6578,"Kolovrat",2017,0,10424668,10424668
6579,"First Daughter",2004,9055010,1364074,10419084
6580,"Inishiêshon rabu",2015,0,10416510,10416510
6581,"Kurosaki-kun no iinari ni nante naranai",2016,0,10415892,10415892
6582,"Sex Drive",2008,8402485,2010000,10412485
6583,"Habemus Papam",2011,486902,9917173,10404075
6584,"Thief of Hearts",1984,10400000,0,10400000
6585,"The High and the Mighty",1954,10400000,0,10400000
6586,"Moby Dick",1956,10400000,0,10400000
6587,"Elmer Gantry",1960,10400000,0,10400000
6588,"Deal of the Century",1983,10400000,0,10400000
6589,"Doctor Detroit",1983,10400000,0,10400000
6590,"Head Over Heels",2001,10397365,0,10397365
6591,"The Man",2005,8330720,2062976,10393696
6592,"Stardust Memories",1980,10389003,0,10389003
6593,"Jeonseolui Joomeok",2013,134213,10254567,10388780
6594,"The Perfect Score",2004,10387706,0,10387706
6595,"Ma-dang-eul Na-on Am-talk",2011,0,10387515,10387515
6596,"All is Lost",2013,6263670,4123144,10386814
6597,"High Society",2017,0,10382876,10382876
6598,"Long Xia Xing Jing",2018,85172,10295882,10381054
6599,"Town & Country",2001,6712451,3652318,10364769
6600,"The Scarlet Letter",1995,10359006,0,10359006
6601,"The Man with Two Brains",1983,10353438,0,10353438
6602,"Sing",1989,2260616,8088834,10349450
6603,"The Newton Boys",1998,10341093,0,10341093
6604,"Yo-kai Watch Movie 5: Forever Friends",2018,0,10336365,10336365
6605,"Satyagraha",2013,738525,9591353,10329878
6606,"Revenge of the Ninja",1983,10325628,0,10325628
6607,"Knock Off",1998,10319915,0,10319915
6608,"I Got the Hook-Up!",1998,10317779,0,10317779
6609,"Hide and Seek",2016,0,10315084,10315084
6610,"Better Off Dead...",1985,10297601,0,10297601
6611,"Galaxy Kaidô",2015,0,10291672,10291672
6612,"Lubov Morkov",2007,0,10291446,10291446
6613,"Kamen Raidâ Heisei Jenerêshonzu Fainaru: Birudo…",2017,0,10289397,10289397
6614,"The Beatles: Eight Days a Week",2016,2934445,7351525,10285970
6615,"Gui Mi 2",2018,37115,10244720,10281835
6616,"Someone to Watch Over Me",1987,10278549,0,10278549
6617,"Bis",2015,0,10252908,10252908
6618,"Facing the Giants",2006,10178331,64828,10243159
6619,"The Bookshop",2017,1600786,8638274,10239060
6620,"Yokokuhan",2015,0,10238535,10238535
6621,"Fan Zhuan Ren Sheng",2017,0,10238078,10238078
6622,"Oddball",2015,0,10237229,10237229
6623,"The Miracle Season",2018,10230620,0,10230620
6624,"White Squall",1996,10229300,0,10229300
6625,"In the Mix",2005,10223896,0,10223896
6626,"Nian Nian You Ai",2015,0,10220378,10220378
6627,"Babes in Toyland",1961,10218316,0,10218316
6628,"Rollover",1981,10217873,0,10217873
6629,"Kuang Shou",2017,0,10217493,10217493
6630,"Snabba Cash",2012,188870,10023533,10212403
6631,"Hak Hap",1999,10211278,0,10211278
6632,"I'll Do Anything",1994,10209111,0,10209111
6633,"Saved!",2004,8886160,1320391,10206551
6634,"Sekai kara neko ga kietanara",2016,0,10203996,10203996
6635,"The Two Faces of January",2014,507463,9693877,10201340
6636,"Meu Passado Me Condena 2",2015,0,10198232,10198232
6637,"Woman on Top",2000,5018450,5174163,10192613
6638,"Flowers in the Shadow",2008,0,10188284,10188284
6639,"Du La La Sheng Zhi Ji 2",2015,0,10187121,10187121
6640,"P2",2007,6348315,3838353,10186668
6641,"You So Crazy",1994,10184701,0,10184701
6642,"The Perfect Match",2016,9669521,512529,10182050
6643,"Henry V",1989,10161099,15602,10176701
6644,"Next Day Air",2009,10027047,145472,10172519
6645,"Look Who's Talking Now",1993,10172124,0,10172124
6646,"Klassentreffen",2018,0,10166333,10166333
6647,"Kohi ga Samenai Uchi Ni",2018,0,10164971,10164971
6648,"Sexy Beast",2001,6946056,3212299,10158355
6649,"Punisher: War Zone",2008,8050977,2106557,10157534
6650,"The Ice Harvest",2005,9016782,1140186,10156968
6651,"Bats",1999,10155691,0,10155691
6652,"We Are Your Friends",2015,3591417,6561998,10153415
6653,"Septimo",2013,0,10145679,10145679
6654,"Lovesick",1983,10143618,0,10143618
6655,"The Secret of Nimh",1982,10140325,0,10140325
6656,"ABCD (Any Body Can Dance)",2013,222098,9915136,10137234
6657,"Father of the Bride",1950,10135000,0,10135000
6658,"Sunset Park",1996,10128314,0,10128314
6659,"Marshall",2017,10051659,65157,10116816
6660,"L'allenatore nel pallone 2",2008,0,10116005,10116005
6661,"Away We Go",2009,9451946,656070,10108016
6662,"Bernie",2012,9204489,902486,10106975
6663,"Bibi & Tina: Tohuwabohu total",2017,0,10097791,10097791
6664,"The Wash",2001,10097096,0,10097096
6665,"Kin",2018,5718096,4378725,10096821
6666,"With Six You Get Eggroll",1968,10095200,0,10095200
6667,"Air Bud: Golden Receiver",1998,10093523,0,10093523
6668,"Under the Cherry Moon",1986,10090429,0,10090429
6669,"A Little Chaos",2015,558173,9526450,10084623
6670,"L'Homme qui rit",2012,46704,10036968,10083672
6671,"Ying Xiong Ben Se 2018",2018,0,10079961,10079961
6672,"Lost in America",1985,10079206,0,10079206
6673,"Edmond",2019,0,10076686,10076686
6674,"Duplex",2003,9652000,418651,10070651
6675,"Kon'ya, romansu gekijô de",2018,0,10068346,10068346
6676,"Deep",2017,0,10068188,10068188
6677,"Shakedown",1988,10068039,0,10068039
6678,"Buddy",1997,10067104,0,10067104
6679,"Taking Woodstock",2009,7460204,2606162,10066366
6680,"Yokame no semi",2011,0,10064960,10064960
6681,"Cyrus",2010,7468936,2593960,10062896
6682,"Boiling Point",1993,10058318,0,10058318
6683,"A Day Without a Mexican",2004,4180870,5877131,10058001
6684,"Open City",2008,0,10051886,10051886
6685,"Elephant",2003,1266955,8784561,10051516
6686,"Mrs. Winterbourne",1996,10039566,0,10039566
6687,"Godzilla 2000",2000,10037390,0,10037390
6688,"Maya the Bee: The Honey Games",2018,0,10033480,10033480
6689,"Milyang",2007,0,10031302,10031302
6690,"Cyborg",1989,10030875,0,10030875
6691,"Nihon no ichiban nagai hi ketteiban",2015,0,10030622,10030622
6692,"Love Is a Many-Splendored Thing",1955,10000000,30091,10030091
6693,"For Greater Glory: The True Story of Cristiada",2012,5669081,4357174,10026255
6694,"Tamjung Hong Gil-dong: Sarajin Ma-eul",2016,67054,9953911,10020965
6695,"Dirty Work",1998,10020081,0,10020081
6696,"Le Violon rouge",1999,10019109,0,10019109
6697,"Aozora êru",2016,0,10017253,10017253
6698,"A Little Princess",1995,10015449,0,10015449
6699,"Lucky Numbers",2000,10014234,0,10014234
6700,"The Unbearable Lightness of Being",1988,10006000,0,10006000
6701,"The Two Jakes",1990,10005969,0,10005969
6702,"King Kong",1933,10000000,650,10000650
6703,"The Snake Pit",1948,10000000,0,10000000
6704,"The Swarm",1978,10000000,0,10000000
6705,"Iron Eagle II",1988,10000000,0,10000000
6706,"Up the Academy",1980,10000000,0,10000000
6707,"State Fair",1945,10000000,0,10000000
6708,"Across 110th Street",1972,10000000,0,10000000
6709,"California Split",1974,10000000,0,10000000
6710,"Margie",1946,10000000,0,10000000
6711,"Gilda",1946,10000000,0,10000000
6712,"So Fine",1981,10000000,0,10000000
6713,"Journey to the Center of the Earth",1959,10000000,0,10000000
6714,"Zorro, The Gay Blade",1981,10000000,0,10000000
6715,"The Big Doll House",1971,10000000,0,10000000
6716,"The Last Detail",1973,10000000,0,10000000
6717,"Disorderlies",1987,10000000,0,10000000
6718,"Maniac",1980,10000000,0,10000000
6719,"Atlantic City",1980,10000000,0,10000000
6720,"Mother Wore Tights",1947,10000000,0,10000000
6721,"The Hollywood Knights",1980,10000000,0,10000000
6722,"The Big Country",1958,10000000,0,10000000
6723,"Judgment at Nuremberg",1961,10000000,0,10000000
6724,"The Dolly Sisters",1945,10000000,0,10000000
6725,"Shaft's Big Score",1972,10000000,0,10000000
6726,"The Singing Fool",1928,10000000,0,10000000
6727,"55 Days at Peking",1963,10000000,0,10000000
6728,"Hud",1963,10000000,0,10000000
6729,"The Ambushers",1968,10000000,0,10000000
6730,"Hankyu Dentetsu",2011,0,9998665,9998665
6731,"Gekijouban Mozu",2015,0,9998652,9998652
6732,"Return to Peyton Place",1961,9996178,0,9996178
6733,"Fanny",1961,9996178,0,9996178
6734,"A Family Thing",1996,9993012,0,9993012
6735,"Thank You for Your Service",2017,9479390,505926,9985316
6736,"The Deep End",2001,8823109,1158526,9981635
6737,"L'incroyable histoire du facteur Cheval",2019,0,9971756,9971756
6738,"Airlift (2016)",2016,0,9969237,9969237
6739,"Mobius",2013,0,9966193,9966193
6740,"Gieokui Bam",2017,0,9965431,9965431
6741,"Shanguang Shaonu",2017,0,9949926,9949926
6742,"Murphy's Law",1986,9947631,0,9947631
6743,"Lassie",1994,9942954,0,9942954
6744,"Mca: Middle Class Abbayi",2017,0,9939186,9939186
6745,"Brazil",1985,9929135,3011,9932146
6746,"The Secret (China)",2016,0,9923066,9923066
6747,"High & Low the Red Rain",2016,0,9921150,9921150
6748,"Once Bitten",1985,9917242,0,9917242
6749,"Everesuto: Kamigami no itadaki",2016,0,9901480,9901480
6750,"Dialogue avec mon jardinier",2007,93604,9803747,9897351
6751,"Night Falls On Manhattan",1997,9889670,0,9889670
6752,"English Vinglish",2012,1862086,8024593,9886679
6753,"Velaikkaran",2017,0,9886215,9886215
6754,"Sarajin Bam",2018,0,9882628,9882628
6755,"Bun Deo Seuteiji: Deo Moobee",2018,0,9881954,9881954
6756,"Explorers",1985,9873000,0,9873000
6757,"Serial",1980,9870727,0,9870727
6758,"Maid to Order",1987,9868000,0,9868000
6759,"Hitler Kaput!",2008,0,9860147,9860147
6760,"The Black Stallion Returns",1983,9851679,0,9851679
6761,"La Grande Seduction",2003,9832874,0,9832874
6762,"Tono, risoku de gozaru!",2016,0,9826255,9826255
6763,"Hanky Panky",1982,9823934,0,9823934
6764,"3 Strikes",2000,9821335,0,9821335
6765,"Badrinath",2011,0,9818936,9818936
6766,"Dudley Do-Right",1999,9818792,0,9818792
6767,"The Express",2008,9793406,19903,9813309
6768,"Jade",1995,9812870,0,9812870
6769,"Peace Breaker",2017,0,9796094,9796094
6770,"Gokaiger Goseiger Super Sentai 199 Hero Great B…",2011,0,9793837,9793837
6771,"Paa",2009,199228,9592054,9791282
6772,"King of Thieves",2018,0,9789472,9789472
6773,"Papa ou Maman 2",2016,0,9789306,9789306
6774,"Os Farofeiros",2018,0,9786399,9786399
6775,"Queen of Katwe",2016,8874389,909945,9784334
6776,"The War of Loong",2017,0,9782949,9782949
6777,"Ivan Tsarevich i Seryy Volk 3",2016,0,9775063,9775063
6778,"The Swan Princess",1994,9771658,0,9771658
6779,"The Rise of a Tomboy",2016,0,9769582,9769582
6780,"Organize Isler Sazan Sarmali",2019,0,9767814,9767814
6781,"Serge Gainsbourg vie heroique",2011,233007,9532354,9765361
6782,"Il a déjà tes yeux",2017,0,9755458,9755458
6783,"The Hidden",1987,9747988,0,9747988
6784,"Immortal Beloved",1994,9743135,0,9743135
6785,"Planeta Singli",2016,0,9740728,9740728
6786,"Maudie",2017,6170998,3564881,9735879
6787,"Running Scared",2006,6855137,2873951,9729088
6788,"New York, I Love You",2009,1588087,8136973,9725060
6789,"Cloak & Dagger",1984,9719952,0,9719952
6790,"The Hole 3D",2012,0,9716671,9716671
6791,"Yugo and Lala 3",2016,0,9714846,9714846
6792,"Chîmu bachisuta no eikô",2008,0,9710761,9710761
6793,"Somewhere in Time",1980,9709597,0,9709597
6794,"Conquest of the Planet of the Apes",1972,9700000,0,9700000
6795,"SpaceCamp",1986,9697739,0,9697739
6796,"Saul fia",2015,1777043,7919494,9696537
6797,"Horst Schlammer - Isch Kandidiere!",2009,0,9692564,9692564
6798,"Vremya Pervyh",2017,0,9690715,9690715
6799,"The Butcher's Wife",1991,9689816,0,9689816
6800,"He Said, She Said",1991,9684702,0,9684702
6801,"Only You",2015,61565,9622002,9683567
6802,"Jerusalem",2013,8020721,1661254,9681975
6803,"S1m0ne",2002,9680913,0,9680913
6804,"Goonghab",2018,0,9680424,9680424
6805,"Shall We Dance?",1997,9676677,0,9676677
6806,"Miracle at St. Anna",2008,7916887,1759610,9676497
6807,"Huan yuè xijù rén",2017,0,9673821,9673821
6808,"Winter in Wartime",2011,542860,9119354,9662214
6809,"Fortuna's Eye",2019,0,9655144,9655144
6810,"Miami Blues",1990,9654290,0,9654290
6811,"Wrongfully Accused",1998,9642860,0,9642860
6812,"Belly",1998,9639390,0,9639390
6813,"Young Black Stallion",2003,6751389,2887000,9638389
6814,"Without a Trace",1983,9632062,0,9632062
6815,"Breakfast at Tiffany's",1961,9551904,68831,9620735
6816,"You zhong ni ai wo",2015,0,9620000,9620000
6817,"I Am Not Your Negro",2017,7123919,2493483,9617402
6818,"Me and You and Everyone We Know",2005,3885134,5730330,9615464
6819,"Come tu mi vuoi",2007,0,9612073,9612073
6820,"On the Waterfront",1954,9600000,0,9600000
6821,"Pepe",1960,9600000,0,9600000
6822,"The Gods Must be Crazy II",1990,6291444,3300000,9591444
6823,"High & Low: The Movie 3 - Final Mission",2017,0,9591095,9591095
6824,"Chashme Baddoor",2013,235401,9352544,9587945
6825,"The Dark Half",1993,9579068,0,9579068
6826,"The Baby-Sitters Club",1995,9574155,0,9574155
6827,"Guzaarish",2010,1026589,8547136,9573725
6828,"Beuiaipi",2017,0,9572938,9572938
6829,"Nichinichi Kore Kôjitsu",2018,0,9572288,9572288
6830,"Every Day",2018,6112914,3453878,9566792
6831,"Monsieur Ibrahim",2004,2824365,6739834,9564199
6832,"Scenes from a Mall",1991,9563393,0,9563393
6833,"Xi Yang Yang Yu Hui Tai Liang Zhi Yang Nian Xi …",2015,0,9562725,9562725
6834,"Traffik",2018,9186156,375075,9561231
6835,"God of War",2017,53496,9506524,9560020
6836,"Popstar: Never Stop Never Stopping",2016,9496130,40990,9537120
6837,"Shade",2004,25032,9508932,9533964
6838,"Hirunaka no ryuusei",2017,0,9525643,9525643
6839,"All the King's Men",2006,7221458,2300000,9521458
6840,"From the Hip",1987,9518342,0,9518342
6841,"Bajirao Mastani",2015,6557047,2959955,9517002
6842,"Open Season 2",2009,0,9510171,9510171
6843,"Thirteen",2003,4601043,4904953,9505996
6844,"Red Rock West",1994,2502551,7000000,9502551
6845,"The Wild Life",1984,9500000,0,9500000
6846,"Míng Yuè Ji Shí You",2017,111584,9387872,9499456
6847,"Rock'n Roll",2017,0,9498348,9498348
6848,"A Thousand Acres",1997,7928412,1568667,9497079
6849,"Animal Crackers",2018,0,9491330,9491330
6850,"Feng Zhong You Duo Yu Zuo De Yun",2019,0,9490000,9490000
6851,"Flesh and Bone",1993,9488998,0,9488998
6852,"Parlami d'amore",2008,0,9482854,9482854
6853,"Ben is Back",2018,3703182,5776300,9479482
6854,"Arrancame la Vida",2008,0,9475906,9475906
6855,"L'Odyssée",2016,0,9472870,9472870
6856,"Mr. Perfect",2011,0,9472240,9472240
6857,"The Station Agent",2003,5801558,3668651,9470209
6858,"The Journey of Natty Gann",1985,9468512,0,9468512
6859,"Hercules",1983,9466655,0,9466655
6860,"Sleeping Beauty",1959,9464608,0,9464608
6861,"Andiamo a quel paese",2014,0,9462298,9462298
6862,"Amos & Andrew",1993,9461630,0,9461630
6863,"Me Case con un Boludo",2016,0,9460591,9460591
6864,"Captivity",2007,2686800,6772940,9459740
6865,"Ahora o nunca",2015,0,9456067,9456067
6866,"The Libertine",2005,4835065,4613558,9448623
6867,"Guilty by Suspicion",1991,9445090,0,9445090
6868,"Belka i Strelka. Zvezdnye sobaki",2010,0,9445081,9445081
6869,"Ta Ra Rum Pum",2007,872643,8571221,9443864
6870,"Criminal Law",1989,9443550,0,9443550
6871,"Viva Las Vegas",1964,9442967,0,9442967
6872,"Veronica Guerin",2003,1569918,7868156,9438074
6873,"Dunston Checks In",1996,9419316,0,9419316
6874,"Secretary",2002,4046737,5367219,9413956
6875,"Sleepover",2004,9408183,0,9408183
6876,"The Brink's Job",1978,9400000,0,9400000
6877,"La Folle Histoire De Max Et Léon",2016,0,9389874,9389874
6878,"Mad Hot Ballroom",2005,8117961,1269620,9387581
6879,"Kidnapping Granny K",2007,0,9386541,9386541
6880,"Osman Pazarlama",2016,0,9385942,9385942
6881,"Ernest et Celestine",2012,292562,9083882,9376444
6882,"Incarnate",2016,4799774,4571262,9371036
6883,"<U+ACE0><U+6B7B>: <U+D53C><U+C758><U+C911><U+AC04><U+ACE0><U+C0AC> (Gosa: piui junggangosa)…",2008,0,9370310,9370310
6884,"Matilda",2017,0,9370285,9370285
6885,"Cave of Forgotten Dreams",2011,5304920,4064709,9369629
6886,"Tuff Turf",1985,9369329,0,9369329
6887,"Amici come Prima",2018,0,9367230,9367230
6888,"Shi Dai Kuang Ren",2019,0,9362134,9362134
6889,"Superbabies: Baby Geniuses 2",2004,9109322,246047,9355369
6890,"Martian Child",2007,7500310,1851779,9352089
6891,"Kisejuu: Part 1",2015,0,9352004,9352004
6892,"Kissing Jessica Stein",2002,7025722,2319339,9345061
6893,"Tri bogatyrya i Naslednitsa prestola",2018,0,9343851,9343851
6894,"Salvando al Soldado Perez",2011,1400726,7929739,9330465
6895,"Ladies in Black",2018,0,9326154,9326154
6896,"Special Citizen",2017,96777,9226275,9323052
6897,"Hellraiser IV: Bloodline",1996,9321492,0,9321492
6898,"Il 7 e l'8",2007,0,9321290,9321290
6899,"We're Back! A Dinosaur's Story",1993,9315576,0,9315576
6900,"On the Road",2012,720828,8592474,9313302
6901,"Open Season 3",2011,0,9312631,9312631
6902,"Jangsanbeom",2017,0,9312084,9312084
6903,"La nouvelle guerre des boutons",2012,45602,9263952,9309554
6904,"Peeples",2013,9177065,130101,9307166
6905,"Black House",2007,0,9306547,9306547
6906,"Bobby Deerfield",1977,9300000,0,9300000
6907,"Serbuan maut",2012,4105123,5192284,9297407
6908,"Chaplin",1992,9289349,0,9289349
6909,"Salaam Namaste",2005,1411065,7876656,9287721
6910,"Stone Cold",1991,9286314,0,9286314
6911,"Lost in Yonkers",1993,9285189,0,9285189
6912,"Me and Earl and the Dying Girl",2015,6758416,2507764,9266180
6913,"Denial",2016,4073448,5190492,9263940
6914,"Le nom des gens",2011,514237,8747474,9261711
6915,"Jerry Springer: Ringmaster",1998,9257103,0,9257103
6916,"Fierce Creatures",1997,9254184,0,9254184
6917,"Angie",1994,9252349,0,9252349
6918,"Lolita",1962,9250000,0,9250000
6919,"Revenge for Love",2017,0,9242543,9242543
6920,"Celtic Pride",1996,9240378,0,9240378
6921,"Ailecek Saskiniz",2018,0,9231581,9231581
6922,"The Interns",1962,9230769,0,9230769
6923,"Bon Voyage!",1962,9230769,0,9230769
6924,"A bout portant",2011,708215,8521942,9230157
6925,"25 km/h",2018,0,9220044,9220044
6926,"Mrs. Brown",1997,9217930,0,9217930
6927,"Everybody's Fine",2009,9208876,0,9208876
6928,"Ng goh siu hai dik hau jeung",2015,0,9208180,9208180
6929,"Mon meilleur ami",2007,1422461,7783474,9205935
6930,"Return of the Living Dead Part II",1988,9205924,0,9205924
6931,"À bras ouverts",2017,0,9201795,9201795
6932,"Çalgi Çengi Ikimiz",2016,0,9201138,9201138
6933,"Havana",1990,9200339,0,9200339
6934,"Dirt",1979,9200000,0,9200000
6935,"The Four Horsemen of the Apocalypse",1921,9200000,0,9200000
6936,"Bad Boys",1983,9200000,0,9200000
6937,"7 Days in Entebbe",2018,3189220,6007520,9196740
6938,"Deux jours à tuer",2008,0,9196127,9196127
6939,"Dukhless 2",2015,0,9194350,9194350
6940,"The Last Women Standing",2015,163406,9027962,9191368
6941,"State and Main",2000,6920692,2261808,9182500
6942,"Boom Town",1940,9172000,0,9172000
6943,"Hairspray",1988,6671108,2500000,9171108
6944,"Chiadan: Joshi kousei ga chiadansu de zenbei se…",2017,0,9170294,9170294
6945,"What's Eating Gilbert Grape",1993,9170214,0,9170214
6946,"Vier Gegen die Bank",2016,0,9165727,9165727
6947,"Planeta Singli 2",2018,0,9164918,9164918
6948,"Dr. Strangelove",1964,9164370,0,9164370
6949,"Becket",1964,9164370,0,9164370
6950,"The Loft",2014,6002684,3152147,9154831
6951,"Evangerion shin gekijôban: Jo",2009,107797,9034766,9142563
6952,"Kardesim Benim",2016,0,9138840,9138840
6953,"Dead Ringers",1988,9134733,0,9134733
6954,"The Valley of Decision",1945,9132000,0,9132000
6955,"Send Me No Flowers",1964,9129247,0,9129247
6956,"Juste La Fin Du Monde",2016,0,9122927,9122927
6957,"Tap",1989,9114702,0,9114702
6958,"Filth",2013,34411,9079853,9114264
6959,"Mientras duermes",2012,0,9109597,9109597
6960,"Naratâju",2017,0,9109549,9109549
6961,"Wo shi lu ren jia",2015,0,9102576,9102576
6962,"Sweet Dreams",1985,9100000,0,9100000
6963,"Meet the Blacks",2016,9097072,0,9097072
6964,"Marguerite",2015,497323,8595029,9092352
6965,"Baram Baram Baram",2018,0,9083567,9083567
6966,"Metallica Through the Never",2013,3419967,5662939,9082906
6967,"A Midsummer Night's Sex Comedy",1982,9077269,0,9077269
6968,"Tu xia zhi qing li chuan shuo",2015,0,9076648,9076648
6969,"Sadako vs. Kayako",2016,0,9075247,9075247
6970,"Cien años de perdón",2016,0,9074836,9074836
6971,"Good Neighbor Sam",1964,9072726,0,9072726
6972,"Brave Story",2006,0,9069428,9069428
6973,"Jagga Jasoos",2017,861740,8193932,9055672
6974,"The Best of Enemies",2019,9049777,0,9049777
6975,"Le premier jour du reste de ta vie",2008,0,9046096,9046096
6976,"La promesse de l'aube",2017,0,9044106,9044106
6977,"Zashchitniki",2017,0,9043794,9043794
6978,"Teukbyeolsusa: Sahyoungsuui Pyeonji",2016,0,9037565,9037565
6979,"El mejor verano de mi vida",2018,0,9036095,9036095
6980,"Snowtime!",2015,0,9034956,9034956
6981,"Frau Müller muss weg!",2015,0,9031225,9031225
6982,"Target",1985,9023199,0,9023199
6983,"Vera Cruz",1954,9000000,18661,9018661
6984,"Trippin’",1999,9017070,0,9017070
6985,"Renegades",1989,9015164,0,9015164
6986,"Red River",1948,9012000,0,9012000
6987,"White Sands",1992,9011574,0,9011574
6988,"The Love Letter",1999,8322608,688372,9010980
6989,"Mr. Smith Goes To Washington",1939,9000000,0,9000000
6990,"Desiree",1954,9000000,0,9000000
6991,"Prince of the City",1981,9000000,0,9000000
6992,"Tribute",1980,9000000,0,9000000
6993,"Bad Dreams",1988,9000000,0,9000000
6994,"Wizards",1977,9000000,0,9000000
6995,"Tom Horn",1980,9000000,0,9000000
6996,"Switching Channels",1988,9000000,0,9000000
6997,"The Conqueror",1956,9000000,0,9000000
6998,"Ben-Hur: A Tale of the Christ",1925,9000000,0,9000000
6999,"Doctor Dolittle",1967,9000000,0,9000000
7000,"Saturn 3",1980,9000000,0,9000000
7001,"Beyond the Valley of the Dolls",1970,9000000,0,9000000
7002,"Bolero",1984,9000000,0,9000000
7003,"A Tree Grows in Brooklyn",1945,9000000,0,9000000
7004,"Love Me Tender",1956,9000000,0,9000000
7005,"Zorba the Greek",1964,9000000,0,9000000
7006,"Cat's Eye",1985,9000000,0,9000000
7007,"The Inn of the Sixth Happiness",1958,9000000,0,9000000
7008,"Ketenpere",2017,0,8992225,8992225
7009,"Deadly Friend",1986,8988731,0,8988731
7010,"Super Express",2016,0,8980243,8980243
7011,"Pei an dong ni du guo man chang sui yue",2015,119376,8851080,8970456
7012,"Neuilly sa mère, sa mère!",2018,0,8970297,8970297
7013,"Cube",1998,489220,8479845,8969065
7014,"The Last Recipe: Kirin no shita no kioku",2017,0,8960664,8960664
7015,"Teaching Mrs. Tingle",1999,8959883,0,8959883
7016,"Truman",2015,210840,8744010,8954850
7017,"Cadillac Records",2008,8195551,746965,8942516
7018,"Half Girlfriend",2017,0,8941750,8941750
7019,"Der Vorname",2018,0,8933387,8933387
7020,"Fatal",2010,0,8929413,8929413
7021,"In the Mouth of Madness",1995,8924549,1254,8925803
7022,"Matinee",1993,8925775,0,8925775
7023,"Brainstorm",1983,8921050,0,8921050
7024,"The Wonderful World of the Brothers Grimm",1962,8920615,0,8920615
7025,"My Cousin Rachel",2017,2716368,6202044,8918412
7026,"Sunny",2008,0,8909089,8909089
7027,"Control",2007,871577,8030564,8902141
7028,"The Formula",1980,8894289,0,8894289
7029,"Mystery, Alaska",1999,8891623,0,8891623
7030,"Deathstalker",1983,8890685,0,8890685
7031,"The Collection",2012,6810754,2079340,8890094
7032,"Sunshine on Leith",2013,0,8890062,8890062
7033,"Honey 2",2010,0,8889625,8889625
7034,"La Pazza Gioia",2016,107362,8771533,8878895
7035,"Sztuka kochania. Historia Michaliny Wislockiej",2017,0,8869241,8869241
7036,"The Inkwell",1994,8864699,0,8864699
7037,"Apt Pupil",1998,8863193,0,8863193
7038,"At Eternity’s Gate",2018,2294917,6567980,8862897
7039,"La befana vien di notte",2018,0,8860898,8860898
7040,"Kokoro ga sakebitagatterunda",2015,0,8854160,8854160
7041,"Hard To Hold",1984,8853155,0,8853155
7042,"Haebing",2017,43144,8806005,8849149
7043,"A Most Violent Year",2014,5749134,3097741,8846875
7044,"Barney's Version",2011,7502560,1343015,8845575
7045,"The Return",2006,7744785,1100000,8844785
7046,"Bo bui gai wak",2006,0,8839526,8839526
7047,"Bastille Day",2016,50269,8781705,8831974
7048,"Aknyeo",2017,27741,8802261,8830002
7049,"Warlock",1991,8824553,0,8824553
7050,"Paulette",2013,29086,8795062,8824148
7051,"Gotcha",1985,8823269,0,8823269
7052,"The River",1984,8818672,0,8818672
7053,"Kinky Boots",2006,1822428,6996000,8818428
7054,"Batterî",2007,0,8808213,8808213
7055,"Body Double",1984,8801940,0,8801940
7056,"Battle for the Planet of the Apes",1973,8800000,0,8800000
7057,"The Hucksters",1947,8800000,0,8800000
7058,"Scandal",1989,8800000,0,8800000
7059,"Oxford Blues",1984,8793000,0,8793000
7060,"Banlieue 13: Ultimatum",2010,36136,8750239,8786375
7061,"Ruby Sparks",2012,2540106,6241952,8782058
7062,"Scandal Maker",2016,0,8772485,8772485
7063,"The Rocker",2008,6409528,2357810,8767338
7064,"Venuto al mondo",2012,0,8764139,8764139
7065,"Chô kôsoku! Sankin kôtai ritânzu",2016,0,8763957,8763957
7066,"Ghost World",2001,6217849,2543759,8761608
7067,"The Square",2017,1502347,7255996,8758343
7068,"Deo ge-im",2008,0,8758154,8758154
7069,"White Fang 2: Myth of the White Wolf",1994,8752399,0,8752399
7070,"The Bachelor and the Bobby-Soxer",1947,8750000,0,8750000
7071,"To Catch a Thief",1955,8750000,0,8750000
7072,"The Pride and the Passion",1957,8750000,0,8750000
7073,"True Believer",1989,8742000,0,8742000
7074,"This is England",2007,327919,8411657,8739576
7075,"Delta Farce",2007,8130530,605378,8735908
7076,"Whatever it Takes",2000,8735529,0,8735529
7077,"Yang Shan Zhou",2011,0,8734350,8734350
7078,"Village of the Damned",1995,8729915,0,8729915
7079,"Champion",2018,97470,8616651,8714121
7080,"Kureyon Shinchan: bakauma! B-kyu gurume sabaiba…",2013,0,8713735,8713735
7081,"Suspect Zero",2004,8712564,0,8712564
7082,"Running With Scissors",2006,6860000,1846701,8706701
7083,"Mischief",1985,8700000,0,8700000
7084,"Dedemin Fisi",2016,0,8698115,8698115
7085,"Patients",2017,0,8693823,8693823
7086,"If You Could See What I Hear",1982,8693512,0,8693512
7087,"Baruto No Gakuen",2006,0,8686010,8686010
7088,"American Splendor",2003,6003587,2682045,8685632
7089,"Chihayafuru Part II",2016,0,8674783,8674783
7090,"Clean and Sober",1988,8674093,0,8674093
7091,"Once Upon a Crime…",1992,8669847,0,8669847
7092,"Kuraimâzu hai",2008,0,8667202,8667202
7093,"Bon Bini Holland 2",2018,0,8664726,8664726
7094,"Postman Pat: The Movie",2014,0,8660022,8660022
7095,"Seuls two",2008,0,8659809,8659809
7096,"Gringo",2018,4969853,3688384,8658237
7097,"Blue Velvet",1986,8551228,105977,8657205
7098,"Ženy v behu",2019,0,8656012,8656012
7099,"The Machinist",2004,1082044,7573353,8655397
7100,"Konna Yofuke Ni Banana Kayo: Kanashiki Jitsuwa",2018,0,8652004,8652004
7101,"The Man With One Red Shoe",1985,8645411,0,8645411
7102,"Before and After",1996,8642118,0,8642118
7103,"Late for Dinner",1991,8641499,0,8641499
7104,"That Was Then… This is Now",1985,8630068,0,8630068
7105,"MacGruber",2010,8525600,104295,8629895
7106,"My iz budushego",2008,0,8623914,8623914
7107,"Secret Admirer",1985,8622757,0,8622757
7108,"Shaandaar",2015,521794,8100000,8621794
7109,"Manhunter",1986,8620929,0,8620929
7110,"Die drei ??? - Das verfluchte Schloss",2015,0,8618118,8618118
7111,"The Bounty",1984,8613462,0,8613462
7112,"Hap Joek Nam Nui",2017,0,8613029,8613029
7113,"L'illusionniste",2010,2231474,6378475,8609949
7114,"Saiki Kusuo no Sainan",2017,0,8608809,8608809
7115,"How She Move",2008,7070641,1537174,8607815
7116,"The Year of Living Dangerously",1983,8601065,0,8601065
7117,"U2: Rattle and Hum",1988,8600823,0,8600823
7118,"Kocan Kadar Konus",2015,0,8595854,8595854
7119,"Fan Zha Feng Bao",2017,0,8595808,8595808
7120,"Our Brand is Crisis",2015,7002261,1592297,8594558
7121,"Xinhai geming",2011,135739,8457415,8593154
7122,"De battre mon coeur s'est arrêté",2005,1023424,7566407,8589831
7123,"The Puppet Masters",1994,8579626,0,8579626
7124,"High Spirits",1988,8578231,0,8578231
7125,"Nanimono",2016,0,8577483,8577483
7126,"Saturno Contro",2007,0,8569001,8569001
7127,"Happiness",2007,0,8567220,8567220
7128,"All Dogs Go To Heaven 2",1996,8556572,0,8556572
7129,"Kwai Boo",2015,0,8550000,8550000
7130,"Peepli Live",2010,754836,7790133,8544969
7131,"Care Bears Movie II: A New Generation",1986,8540346,0,8540346
7132,"Albert Nobbs",2011,3014696,5524307,8539003
7133,"The Rich Man’s Wife",1996,8538318,0,8538318
7134,"Mausam",2011,725966,7810976,8536942
7135,"Leprechaun",1993,8533294,0,8533294
7136,"The Big Brawl",1980,8527743,0,8527743
7137,"L'abbiamo fatta grossa",2016,0,8520685,8520685
7138,"The Warrior's Way",2010,5666340,2847985,8514325
7139,"Bao Lie Wu Sheng",2018,0,8512220,8512220
7140,"Pope Francis—A Man of His Word",2018,2008385,6497370,8505755
7141,"Before Night Falls",2000,4221817,4281642,8503459
7142,"Gus, petit oiseau grand voyage",2014,0,8503401,8503401
7143,"Fishermen's Friends",2019,0,8501743,8501743
7144,"Seupeulrit",2016,0,8491292,8491292
7145,"Unstoppable Marriage",2007,0,8491265,8491265
7146,"Big Trouble",2002,7262288,1226583,8488871
7147,"Apollo 11",2019,8484424,0,8484424
7148,"Une heure de tranquillité",2015,0,8482884,8482884
7149,"What We Do in the Shadows",2014,3469224,5012132,8481356
7150,"Nothing But Trouble",1991,8479793,0,8479793
7151,"Hilfe, Ich Hab Meine Lehrerin Geschrumpft",2015,0,8477416,8477416
7152,"Wise Guys",1986,8475466,0,8475466
7153,"Danny Collins",2015,5637066,2828779,8465845
7154,"Zuì ài",2011,0,8463200,8463200
7155,"Bitva za Sevastopol",2015,0,8455667,8455667
7156,"Vacanze ai Caraibi - Il film di Natale",2015,0,8447319,8447319
7157,"Casa de mi Padre",2012,5909483,2537469,8446952
7158,"Tender Mercies",1983,8443124,0,8443124
7159,"Tayna Sukharevoy bashni. Charodey ravnovesiya",2015,0,8442829,8442829
7160,"John Carpenter’s Ghosts of Mars",2001,8434601,0,8434601
7161,"Play it to the Bone",1999,8427204,0,8427204
7162,"Kimi wa Tsukiyo ni Hikarikagayaku",2019,0,8426227,8426227
7163,"The Awakening",1980,8415112,0,8415112
7164,"Pushing Tin",1999,8408835,0,8408835
7165,"10 giorni senza mamma",2019,0,8403212,8403212
7166,"All About Eve",1950,8400000,0,8400000
7167,"Meteor",1979,8400000,0,8400000
7168,"Carbon Copy",1981,8400000,0,8400000
7169,"Country",1984,8400000,0,8400000
7170,"Pinky",1949,8400000,0,8400000
7171,"Body Parts",1991,8398855,0,8398855
7172,"Love Me If You Dare",2004,548707,7838323,8387030
7173,"Bones",2001,7316658,1062195,8378853
7174,"The Importance of Being Earnest",2002,8378141,0,8378141
7175,"Planet Terror",2007,0,8374592,8374592
7176,"Death to Smoochy",2002,8355815,18247,8374062
7177,"The Last Temptation of Christ",1988,8373585,0,8373585
7178,"Jhoom Barabar Jhoom",2007,695156,7675509,8370665
7179,"Nineteen Eighty-Four",1984,8368371,0,8368371
7180,"Captive State",2019,5958315,2409042,8367357
7181,"Turbo: A Power Rangers Movie",1997,8363899,0,8363899
7182,"Something Wild",1986,8362000,0,8362000
7183,"Bon Voyage",2004,2353728,6008008,8361736
7184,"Yves St. Laurent",2004,97092,8263004,8360096
7185,"A Beautiful Planet",2016,7895708,459936,8355644
7186,"Bibi & Tina",2014,0,8354458,8354458
7187,"Gekijô-ban Kamen Raidâ Den-Ô: Ore, tanjô!",2007,0,8353721,8353721
7188,"Return to Paradise",1998,8352677,0,8352677
7189,"Asu Mare",2013,0,8350544,8350544
7190,"Mitt liv som hund",1987,8345266,0,8345266
7191,"Siganitalga",2016,58689,8281286,8339975
7192,"Demain",2015,43471,8295068,8338539
7193,"Twin Dragons",1999,8332431,0,8332431
7194,"R.T.T.",2009,0,8322166,8322166
7195,"Terror in the Aisles",1984,8316206,0,8316206
7196,"Bug",2007,7006708,1296287,8302995
7197,"Mr. Jones",1993,8302752,0,8302752
7198,"Chasing Mavericks",2012,6002756,2298065,8300821
7199,"Gromkaya svyaz",2019,0,8300123,8300123
7200,"Larger Than Life",1996,8295903,0,8295903
7201,"Beyond the Sea",2004,6144806,2148108,8292914
7202,"Hilfe, Ich Hab Meine Eltern Geschrumpft",2018,0,8292310,8292310
7203,"Batalon",2015,0,8292235,8292235
7204,"Bébé's Kids",1992,8284881,0,8284881
7205,"Proof",2005,7535331,749000,8284331
7206,"HUGtto! Pretty Cure<U+2661>Futari wa Pretty Cure: All …",2018,0,8283912,8283912
7207,"Shadow of the Vampire",2000,8279017,0,8279017
7208,"Mamá se fue de viaje",2017,0,8276056,8276056
7209,"Hard Candy",2006,1024640,7242426,8267066
7210,"Lubov Morkov 3",2011,0,8264969,8264969
7211,"Tong que tai",2012,0,8264881,8264881
7212,"A.X.L.",2018,6501381,1758372,8259753
7213,"Connasse, princesse des coeurs",2015,0,8257617,8257617
7214,"Suite française",2015,0,8256349,8256349
7215,"Alan Partridge",2014,153426,8100000,8253426
7216,"Satisfaction",1988,8253123,0,8253123
7217,"Gnome Alone",2018,0,8252718,8252718
7218,"Christopher Columbus: The Discovery",1992,8251071,0,8251071
7219,"The Blob",1988,8247943,0,8247943
7220,"Tall Tale",1995,8247627,0,8247627
7221,"More Than Honey",2012,78324,8165747,8244071
7222,"White Noise 2: The Light",2008,0,8243567,8243567
7223,"Kill Me Please",2017,0,8242805,8242805
7224,"Gekijouban Kuroko no basuke: Last Game",2017,0,8229992,8229992
7225,"Hoot",2006,8117637,107361,8224998
7226,"Le Vin et le Vent",2017,257610,7965527,8223137
7227,"The Children of Huang Shi",2008,1031872,7189828,8221700
7228,"The Homesman",2014,2429989,5787582,8217571
7229,"Black Robe",1991,8211952,0,8211952
7230,"La véritable histoire du Chat Botté",2011,0,8208594,8208594
7231,"Gladiator",1992,8205703,0,8205703
7232,"Dr. Giggles",1992,8205290,0,8205290
7233,"Ballon",2018,0,8204697,8204697
7234,"Funny Games",2008,1294640,6905487,8200127
7235,"Lucas",1986,8200000,0,8200000
7236,"McCabe & Mrs. Miller",1971,8200000,0,8200000
7237,"The Misfits",1961,8200000,0,8200000
7238,"Hondo",1953,8200000,0,8200000
7239,"Sardaar Ji",2015,0,8200000,8200000
7240,"Shootout at Lokhandwala",2007,289232,7901847,8191079
7241,"Natale col Boss",2015,0,8184974,8184974
7242,"The House on Sorority Row",1983,8184633,0,8184633
7243,"City Island",2010,6671283,1502203,8173486
7244,"Underground Rendez-vous",2007,0,8165482,8165482
7245,"A Simple Wish",1997,8165213,0,8165213
7246,"Miss You Already",2015,1162653,7001396,8164049
7247,"Salut D’Amour",2015,0,8158535,8158535
7248,"Adopte un veuf",2016,0,8157165,8157165
7249,"Will You Be There?",2016,0,8154239,8154239
7250,"Hwanggeo: Yukwansun Iyagi",2019,0,8148634,8148634
7251,"Ostwind 2",2015,0,8145623,8145623
7252,"Code Name: The Cleaner",2007,8135024,0,8135024
7253,"Haru",2017,0,8134330,8134330
7254,"Irreversible",2003,792200,7341056,8133256
7255,"Birthday Girl",2002,4919896,3210831,8130727
7256,"Key Largo",1948,8125000,4920,8129920
7257,"Funny About Love",1990,8128773,0,8128773
7258,"The Rising",2005,939363,7187968,8127331
7259,"BLUE",2009,321640,7804333,8125973
7260,"Firestorm",1998,8123860,0,8123860
7261,"Days of Wine and Roses",1962,8123077,0,8123077
7262,"Things We Lost in the Fire",2007,3287315,4832833,8120148
7263,"Replicas",2018,4046429,4072814,8119243
7264,"Après vous...",2005,830292,7274721,8105013
7265,"The Philadelphia Experiment",1984,8103330,0,8103330
7266,"More American Graffiti",1979,8100000,0,8100000
7267,"Shoot the Moon",1982,8100000,0,8100000
7268,"Fresh",1994,8094616,0,8094616
7269,"The Man Who Invented Christmas",2017,5676110,2416747,8092857
7270,"Cafarnaúm",2018,1628639,6462775,8091414
7271,"Nick of Time",1995,8087783,0,8087783
7272,"L'auberge rouge",2008,50304,8034067,8084371
7273,"Sauver ou périr",2018,0,8080011,8080011
7274,"Animal Kingdom",2010,1044039,7034644,8078683
7275,"Woo",1998,8064972,0,8064972
7276,"Unutursam Fisilda",2014,0,8063509,8063509
7277,"Sahara",2017,0,8061843,8061843
7278,"Hagane no Renkinjutsushi",2017,0,8053641,8053641
7279,"Yu jian ni zhen hao",2018,0,8051388,8051388
7280,"Le passe",2013,1335672,6714235,8049907
7281,"Veer",2010,527193,7522669,8049862
7282,"Connie & Carla",2004,8047525,0,8047525
7283,"Code Geass: Fukkatsu No Lelouch",2019,0,8046806,8046806
7284,"Soof 2",2016,0,8040606,8040606
7285,"The Adventures of Baron Munchausen",1989,8040008,0,8040008
7286,"A Late Quartet",2012,1561577,6477215,8038792
7287,"Sommer",2008,0,8034431,8034431
7288,"Haunted Honeymoon",1986,8033397,0,8033397
7289,"The Texas Chainsaw Massacre 2",1986,8025872,0,8025872
7290,"Black Water",2018,0,8023159,8023159
7291,"Our Kind of Traitor",2016,3153157,4864780,8017937
7292,"The Meteor Man",1993,8015592,0,8015592
7293,"No Problem",2010,285468,7729691,8015159
7294,"Ningyo no nemuru ie",2018,0,8011220,8011220
7295,"Bingo",1991,8011019,0,8011019
7296,"DONGJU; The Portrait of A Poet",2016,56184,7948099,8004283
7297,"Child 44",2015,1224330,6779891,8004221
7298,"The Sweeney",2012,26345,7974021,8000366
7299,"Islands in the Stream",1977,8000000,0,8000000
7300,"King of the Gypsies",1978,8000000,0,8000000
7301,"Without a Clue",1988,8000000,0,8000000
7302,"Robin and Marian",1976,8000000,0,8000000
7303,"Love Me or Leave Me",1955,8000000,0,8000000
7304,"The Three Musketeers",1948,8000000,0,8000000
7305,"Do Not Disturb",1965,8000000,0,8000000
7306,"Nightbreed",1990,8000000,0,8000000
7307,"Salsa",1988,8000000,0,8000000
7308,"Sweet Charity",1969,8000000,0,8000000
7309,"The Man Who Shot Liberty Valance",1962,8000000,0,8000000
7310,"Paradise Alley",1978,8000000,0,8000000
7311,"Terror Train",1980,8000000,0,8000000
7312,"A Streetcar Named Desire",1951,8000000,0,8000000
7313,"Ski Patrol",1990,8000000,0,8000000
7314,"The Taming of the Shrew",1967,8000000,0,8000000
7315,"Indiscreet",1958,8000000,0,8000000
7316,"Annie Get Your Gun",1950,8000000,0,8000000
7317,"Force: Five",1981,8000000,0,8000000
7318,"Casey's Shadow",1978,8000000,0,8000000
7319,"Island in the Sun",1957,8000000,0,8000000
7320,"Come to the Stable",1949,8000000,0,8000000
7321,"The Devil's Brigade",1968,8000000,0,8000000
7322,"High Noon",1952,8000000,0,8000000
7323,"Rooster Cogburn",1975,8000000,0,8000000
7324,"The Undefeated",1969,8000000,0,8000000
7325,"Cat People",1942,4000000,4000000,8000000
7326,"The Agony and the Ecstasy",1965,8000000,0,8000000
7327,"20,000 Leagues Under the Sea",1916,8000000,0,8000000
7328,"Mia madre",2015,303002,7687476,7990478
7329,"Where Were You When the Lights Went Out?",1968,7988000,0,7988000
7330,"My Giant",1998,7985929,0,7985929
7331,"The Pirate Movie",1982,7983086,0,7983086
7332,"Kita no sakuramori",2018,0,7978105,7978105
7333,"Mid90s",2018,7362439,615476,7977915
7334,"Tanu Weds Manu",2011,240020,7736368,7976388
7335,"Impostor",2002,6114237,1860370,7974607
7336,"Gurasuhoppâ",2015,0,7971675,7971675
7337,"Fiksiki Bol Shoy Sekret 1",2017,0,7971261,7971261
7338,"Alles is Liefde",2014,0,7966048,7966048
7339,"Missing: Sarajin Yeoja",2016,0,7963688,7963688
7340,"The Sweet Hereafter",1997,4306697,3644550,7951247
7341,"Dazed and Confused",1993,7950889,0,7950889
7342,"Naruto Shippuden: The Movie",2017,0,7947209,7947209
7343,"Le Grand Mechant Renard et Autres Contes...",2017,66854,7880270,7947124
7344,"Dai-Nipponjin",2009,40796,7905169,7945965
7345,"Gogol: Nachalo",2017,0,7939757,7939757
7346,"Kurbaan",2009,754269,7183886,7938155
7347,"La Matassa",2009,0,7937165,7937165
7348,"Runaway Train",1985,7936012,0,7936012
7349,"Unstrung Heroes",1995,7929000,0,7929000
7350,"All the Best: Fun Begins",2009,120713,7804333,7925046
7351,"Hwang Jin-yi",2007,0,7923851,7923851
7352,"Ali Baba ve 7 Cüceler",2015,0,7920926,7920926
7353,"Strange Days",1995,7918562,0,7918562
7354,"Planeta Singli 3",2019,0,7912933,7912933
7355,"La fille coupée en deux",2008,409658,7500000,7909658
7356,"Shao nian ban",2015,53252,7850000,7903252
7357,"The Alamo",1960,7900000,0,7900000
7358,"The Final Master",2015,0,7900000,7900000
7359,"Gansin",2015,0,7899033,7899033
7360,"Overdrive",2017,0,7898242,7898242
7361,"Gekijô-ban Kamen Raidâ Gôsuto: 100 no Eyecon to…",2016,0,7897263,7897263
7362,"Stronger",2017,4211129,3677738,7888867
7363,"Teen Wolf Too",1987,7888000,0,7888000
7364,"Centurion",2010,123570,7761478,7885048
7365,"Cheetah",1989,7882250,0,7882250
7366,"Un homme à la hauteur",2016,0,7882126,7882126
7367,"Serial Mom",1994,7881335,0,7881335
7368,"Revolver",2007,84738,7795830,7880568
7369,"Bunty Aur Babli",2005,932509,6944212,7876721
7370,"Lassie",2006,652163,7223748,7875911
7371,"For a Few Bullets",2016,30142,7841485,7871627
7372,"The Clearing",2004,5763875,2100000,7863875
7373,"Cedar Rapids",2011,6861102,1001029,7862131
7374,"Pele: Birth of a Legend",2016,49979,7809018,7858997
7375,"The Great White Hype",1996,7852282,0,7852282
7376,"Seinto Seiya: Legend of Sanctuary",2015,0,7851441,7851441
7377,"La Vénus à la fourrure",2014,342183,7503022,7845205
7378,"Aspen Extreme",1993,7843388,0,7843388
7379,"Bad Words",2014,7779614,63531,7843145
7380,"Fatal Instinct",1993,7839327,0,7839327
7381,"Cheeni Kum",2007,678792,7158882,7837674
7382,"Un Nonio Para Mi Mujer",2008,0,7836499,7836499
7383,"The Chase",1994,7836488,0,7836488
7384,"7 Guardians of the Tomb",2018,0,7835554,7835554
7385,"Vampire Academy",2014,7791979,42846,7834825
7386,"Première année",2018,0,7833451,7833451
7387,"Manuale D'Amore 3",2012,0,7829947,7829947
7388,"The Little Drummer Girl",1984,7828841,0,7828841
7389,"Outside Providence",1999,7309628,514730,7824358
7390,"Venus",2006,3347411,4471068,7818479
7391,"Reonningmaen",2013,0,7818396,7818396
7392,"Tenkû no hachi",2015,0,7816962,7816962
7393,"Enemies: A Love Story",1989,7815403,0,7815403
7394,"Desi Boyz",2011,1066167,6746144,7812311
7395,"Guo Nian Hao",2016,25358,7783577,7808935
7396,"Tupac Resurrection",2003,7718961,89563,7808524
7397,"Señor, Dame Paciencia",2017,0,7805091,7805091
7398,"Pitbull. Nowe porzadki",2016,0,7802960,7802960
7399,"Carrossel: O Filme",2015,0,7802639,7802639
7400,"Sands of Iwo Jima",1949,7800000,0,7800000
7401,"Gentleman's Agreement",1947,7800000,0,7800000
7402,"House II: The Second Story",1987,7800000,0,7800000
7403,"All Night Long",1981,7800000,0,7800000
7404,"Inside Job",2010,4311834,3487423,7799257
7405,"Moshi Koko Yakyu no Joshi Manager ga Drucker no…",2011,0,7797606,7797606
7406,"Little Buddha",1994,4793587,3000000,7793587
7407,"The Best of Times",1986,7790931,0,7790931
7408,"Return of the Cuckoo",2015,0,7790420,7790420
7409,"In the Loop",2009,2388804,5400000,7788804
7410,"Nowhere Boy",2010,1445366,6339863,7785229
7411,"If Looks Could Kill",1991,7781025,0,7781025
7412,"Lian Ai Zhong De Cheng Shi",2015,0,7780000,7780000
7413,"Real Women Have Curves",2002,5853194,1924596,7777790
7414,"Les souvenirs",2015,0,7777531,7777531
7415,"Hoshi Mamoru Inu",2011,0,7772082,7772082
7416,"Sirens",1994,7770731,0,7770731
7417,"Smoke Signals",1998,6719300,1037317,7756617
7418,"DOA: Dead or Alive",2007,480314,7275372,7755686
7419,"I Was a Male War Bride",1949,7750000,0,7750000
7420,"Small Town Rivals",2007,0,7741557,7741557
7421,"Yin Bao Zhe",2017,118384,7618024,7736408
7422,"Cry-Baby",1990,7735790,0,7735790
7423,"The Hunting Party",2007,876671,6852881,7729552
7424,"Deepstar Six",1989,7724847,0,7724847
7425,"Finding Fanny",2014,623229,7100000,7723229
7426,"A New Life",1988,7721851,0,7721851
7427,"Expelled: No Intelligence Allowed",2008,7720487,0,7720487
7428,"Miss Sloane",2016,3500605,4219025,7719630
7429,"The Manchurian Candidate",1962,7716923,0,7716923
7430,"Axel 2: Adventures of the Spacekids",2017,0,7714127,7714127
7431,"Kevin Hart: Laugh at My Pain",2011,7706436,6000,7712436
7432,"Yuki no Hana",2019,0,7709399,7709399
7433,"L'Empereur de Paris",2018,0,7708262,7708262
7434,"Dheepan",2015,248795,7455562,7704357
7435,"Amityville: The Awakening",2017,742,7701166,7701908
7436,"Blue Steel",1990,7701707,0,7701707
7437,"Mr. & Mrs. Bridge",1990,7698000,0,7698000
7438,"Leave No Trace",2018,6046104,1645863,7691967
7439,"Wake Up Sid",2009,718766,6973153,7691919
7440,"Qian ting zong dong yuan 5: shi guang bao he",2015,0,7691563,7691563
7441,"Surviving the Game",1994,7690013,0,7690013
7442,"Love Live! Sunshine!! The School Idol Movie Ove…",2019,0,7687514,7687514
7443,"3 Idiotas",2017,1249233,6435452,7684685
7444,"The Big Year",2011,7204138,480386,7684524
7445,"Strictly Business",1991,7683267,0,7683267
7446,"Twice in a Lifetime",1985,7681246,0,7681246
7447,"Midnight Special",2016,3712282,3967968,7680250
7448,"Insane",2016,0,7678288,7678288
7449,"We Are Family",2010,638144,7040003,7678147
7450,"The Healer",2017,0,7678017,7678017
7451,"Parlez-moi de la pluie",2010,111844,7564630,7676474
7452,"Tini: El gran cambio de Violetta",2016,0,7674680,7674680
7453,"Mo jing",2014,172010,7500000,7672010
7454,"La Vache",2016,0,7668880,7668880
7455,"Young @ Heart",2008,3992189,3657066,7649255
7456,"Dywizjon 303",2018,0,7646292,7646292
7457,"Sauerkrautkoma",2018,0,7640109,7640109
7458,"Quicksilver",1986,7634909,0,7634909
7459,"Hua Li Shang Ban Zou",2015,63029,7570368,7633397
7460,"Dog Days",2018,6809080,823355,7632435
7461,"La mujer de mi hermano",2006,2808241,4813787,7622028
7462,"Papillon",2018,2335896,5282225,7618121
7463,"Ninja III: The Domination",1984,7610785,0,7610785
7464,"The Spy Who Came in from the Cold",1965,7600000,0,7600000
7465,"The Quiet Man",1952,7600000,0,7600000
7466,"The Hustler",1961,7600000,0,7600000
7467,"120 battements par minute",2017,125189,7468823,7594012
7468,"Mao Yu Tao Hua Yuan",2018,0,7590493,7590493
7469,"The Amazing Panda Adventure",1995,7590169,0,7590169
7470,"The Immigrant",2014,2013456,5571555,7585011
7471,"Ong-Bak 2",2009,102458,7480592,7583050
7472,"Churchill",2017,1279681,6302515,7582196
7473,"Zhenikh",2016,0,7579923,7579923
7474,"Take Me Home Tonight",2011,6928068,648536,7576604
7475,"L'ascension",2017,0,7573667,7573667
7476,"Club Dread",2004,5001655,2571896,7573551
7477,"Krippendorf's Tribe",1998,7571115,0,7571115
7478,"Losing Isaiah",1995,7564608,0,7564608
7479,"El Cantante",2007,7556004,0,7556004
7480,"The Jerky Boys",1995,7555256,0,7555256
7481,"Sprung",1997,7553105,0,7553105
7482,"Mortadelo y Filemón. Misión: Salvar la Tierra",2008,0,7541906,7541906
7483,"Grandma",2015,6980524,557085,7537609
7484,"Damage",1992,7532911,0,7532911
7485,"Cong Tian Er Jiang",2015,0,7530000,7530000
7486,"My Old Lady",2014,4011530,3517296,7528826
7487,"Nothing Like the Holidays",2008,7503736,15754,7519490
7488,"Just the Way You Are",1984,7517699,0,7517699
7489,"Tashan",2008,457380,7055067,7512447
7490,"Donnie Darko",2001,1480006,6030871,7510877
7491,"Big Jake",1971,7500000,0,7500000
7492,"How to Beat the High Co$t of Living",1980,7500000,0,7500000
7493,"The Cowboys",1972,7500000,0,7500000
7494,"Walk Don't Run",1966,7500000,0,7500000
7495,"Night and Day",1946,7500000,0,7500000
7496,"Agatha",1979,7500000,0,7500000
7497,"An Eye for an Eye",1981,7496681,0,7496681
7498,"Hackers",1995,7487370,0,7487370
7499,"The Babadook",2014,950792,6531595,7482387
7500,"Le Grand Partage",2015,0,7481752,7481752
7501,"The Little Vampire",2017,0,7481751,7481751
7502,"Kidnap",2008,328573,7143415,7471988
7503,"Gogol. Viy.",2018,0,7471349,7471349
7504,"Foxes",1980,7470348,0,7470348
7505,"Bhaagamathie",2018,0,7468217,7468217
7506,"Stealing Home",1988,7467504,0,7467504
7507,"The Trip to Bountiful",1985,7466662,0,7466662
7508,"I'll See You in My Dreams",2015,7449681,15084,7464765
7509,"Seong-nan Byeon-ho-sa",2015,0,7457770,7457770
7510,"Spellbound",2003,5728581,1729129,7457710
7511,"Ostwind - Aufbruch nach Ora",2017,0,7456105,7456105
7512,"Dog 13",2018,0,7448509,7448509
7513,"Compadres",2016,3127773,4317271,7445044
7514,"You Were Never Really Here",2017,2523610,4914888,7438498
7515,"Maximum Overdrive",1986,7433663,0,7433663
7516,"5×2",2005,128752,7300000,7428752
7517,"Duan Pian Er",2018,0,7423443,7423443
7518,"2 Days in New York",2012,633210,6785462,7418672
7519,"London Dreams",2009,300293,7117989,7418282
7520,"The Cook, The Thief, His Wife, and Her Lover",1990,7407995,0,7407995
7521,"Tracks",2014,509815,6896415,7406230
7522,"A Scanner Darkly",2006,5501616,1903468,7405084
7523,"Beirut",2018,5019226,2385588,7404814
7524,"Prizrak",2015,0,7402809,7402809
7525,"Midnight Lace",1960,7400000,0,7400000
7526,"Separate Tables",1958,7400000,0,7400000
7527,"Sai Er Hao 5",2015,0,7400000,7400000
7528,"Poveri ma Ricchissimi",2017,0,7396878,7396878
7529,"Blankman",1994,7395486,0,7395486
7530,"Ironweed",1987,7393346,0,7393346
7531,"La princesse de Montpensier",2011,352428,7040068,7392496
7532,"Bizan",2007,0,7391563,7391563
7533,"Requiem for a Dream",2000,3635482,3753751,7389233
7534,"Kiki, el amor se hace",2016,12450,7373724,7386174
7535,"The Five Heartbeats",1991,7377189,0,7377189
7536,"Bushwhacked",1995,7377107,0,7377107
7537,"It Runs in the Family",2003,7375836,0,7375836
7538,"The Condemned",2007,7371706,0,7371706
7539,"Witchboard",1986,7369373,0,7369373
7540,"Wild America",1997,7365417,0,7365417
7541,"Greenberg",2010,4234170,3128812,7362982
7542,"Frantz",2016,880883,6475444,7356327
7543,"Lolo",2015,24134,7331762,7355896
7544,"God’s Not Dead: A Light in Darkness",2018,5728940,1625821,7354761
7545,"Reisen til julestjernen",2012,0,7354318,7354318
7546,"A Xiu Luo",2018,0,7353354,7353354
7547,"The Crucible",1996,7352332,0,7352332
7548,"Clean Slate",1994,7352116,0,7352116
7549,"Precure Miracle Universe Movie",2019,0,7350621,7350621
7550,"Clifford",1994,7347669,0,7347669
7551,"Iceman",1984,7343032,0,7343032
7552,"Eiga: Kurosagi",2008,0,7336788,7336788
7553,"Alice",1990,7331647,0,7331647
7554,"Alex:the floating planet",2017,0,7330000,7330000
7555,"The Young Messiah",2016,6469813,843884,7313697
7556,"Mafiya: Igra na vyzhivanie",2016,0,7313343,7313343
7557,"E Linh Zhi Men",2016,0,7312653,7312653
7558,"Mississippi Masala",1992,7308786,0,7308786
7559,"Sarafina!",1992,7306242,0,7306242
7560,"Who's That Girl?",1987,7305000,0,7305000
7561,"Phat Girlz",2006,7061128,239987,7301115
7562,"Thank God It's Friday",1978,7300000,0,7300000
7563,"Wild Hearts Can't Be Broken",1991,7300000,0,7300000
7564,"How to Marry a Millionaire",1953,7300000,0,7300000
7565,"Gigi",1958,7300000,0,7300000
7566,"Goodbye Christopher Robin",2017,1735251,5564411,7299662
7567,"Morgan",2016,3915251,3383535,7298786
7568,"Eat Drink Man Woman",1994,7294403,0,7294403
7569,"Beatriz at Dinner",2017,7115854,178182,7294036
7570,"Respiro",2003,1072534,6216879,7289413
7571,"Black Nativity",2013,7018188,266947,7285135
7572,"Pride",2014,1447022,5838077,7285099
7573,"Shadows in the Palace",2007,0,7284511,7284511
7574,"Phantasm II",1988,7282851,0,7282851
7575,"She's So Lovely",1997,7281450,0,7281450
7576,"P to JK",2017,0,7278360,7278360
7577,"Searching for Bobby Fischer",1993,7266393,0,7266393
7578,"Genius",2016,1361045,5904238,7265283
7579,"Poveri ma Ricchi",2016,0,7259767,7259767
7580,"Le Prix a Payer",2007,0,7250992,7250992
7581,"Ben Ai",2016,0,7250876,7250876
7582,"[Rec] 3: Genesis",2012,9600,7241000,7250600
7583,"Kaminey",2009,1286143,5963446,7249589
7584,"B*A*P*S",1997,7246735,0,7246735
7585,"Off Limits",1988,7242035,0,7242035
7586,"Wo Zhi Nv Ren Xin",2011,123527,7118400,7241927
7587,"Rush",1991,7241350,0,7241350
7588,"The Missionary",1982,7241180,0,7241180
7589,"Le Flic de Belleville",2018,0,7238676,7238676
7590,"Bibi & Tina voll verhext!",2014,0,7237072,7237072
7591,"I Know Who Killed Me",2007,7233485,0,7233485
7592,"Let There Be Light",2017,7233471,0,7233471
7593,"Under the Skin",2014,2614251,4615682,7229933
7594,"Udon",2006,0,7229481,7229481
7595,"L'hermine",2015,0,7227174,7227174
7596,"Barcelona",1994,7224321,0,7224321
7597,"Hanni & Nanni",2010,0,7223509,7223509
7598,"Die kommenden Tage",2010,0,7221324,7221324
7599,"Inu to watashi no 10 no yakusoku",2008,0,7220517,7220517
7600,"Birth of the Dragon",2017,6901965,318525,7220490
7601,"Hannah Arendt",2013,717205,6502580,7219785
7602,"La Tribu",2018,0,7215967,7215967
7603,"Napoli Velata",2017,0,7210459,7210459
7604,"Disorganized Crime",1989,7210149,0,7210149
7605,"The Big Red One",1980,7206220,0,7206220
7606,"Life Before Her Eyes",2008,303439,6900000,7203439
7607,"Bachna Ae Haseeno",2008,702166,6500000,7202166
7608,"Trail of the Pink Panther",1982,7201697,0,7201697
7609,"Transylvania 6-5000",1985,7200000,0,7200000
7610,"Singin' in the Rain",1952,7200000,0,7200000
7611,"Tex",1982,7199408,0,7199408
7612,"Grâce à dieu",2019,0,7199079,7199079
7613,"Disobedience",2018,3480702,3714403,7195105
7614,"Jalsa",2008,0,7194096,7194096
7615,"Troop Beverly Hills",1989,7190505,0,7190505
7616,"Zeus and Roxanne",1997,7183046,0,7183046
7617,"Mujeres al borde de un ataque de nervios",1988,7179000,0,7179000
7618,"Rémi sans famille",2018,0,7178167,7178167
7619,"The Boy Who Could Fly",1986,7177431,0,7177431
7620,"10 to Midnight",1983,7175592,0,7175592
7621,"Obsluhoval jsem anglického krále",2008,617228,6557756,7174984
7622,"Simmba",2018,5102129,2072248,7174377
7623,"Les vieux fourneaux",2018,0,7168974,7168974
7624,"Deliha",2014,0,7167286,7167286
7625,"Absolutely Anything",2015,0,7167019,7167019
7626,"The Hoax",2007,7164995,0,7164995
7627,"Mugen no jûnin",2017,150532,7014045,7164577
7628,"Toc Toc",2017,0,7163058,7163058
7629,"Then She Found Me",2008,3735717,3427203,7162920
7630,"Who Am I - Kein System ist sicher",2014,0,7153465,7153465
7631,"The Name of the Rose",1986,7153000,0,7153000
7632,"À fond",2016,0,7152868,7152868
7633,"Gogol. Strashnaya mest",2018,0,7150592,7150592
7634,"Zhi Shao Hai You Ni",2015,0,7150000,7150000
7635,"Condorito: La Pelicula",2017,447719,6699289,7147008
7636,"Cuerpo de élite",2016,0,7145405,7145405
7637,"20th Century Women",2016,5664763,1480125,7144888
7638,"Journey to the South Pacific",2013,7144210,0,7144210
7639,"Lorenzo’s Oil",1992,7144115,0,7144115
7640,"Babushka lyogkogo povedeniya - 2",2019,0,7142802,7142802
7641,"Caos Calmo",2009,11434,7130788,7142222
7642,"She's Gotta Have It",1986,7137502,0,7137502
7643,"Exit Through the Gift Shop",2010,3291250,3841439,7132689
7644,"Bo fung yu",2015,0,7129755,7129755
7645,"Hamlet",1996,4501094,2628576,7129670
7646,"Gigli",2003,6087542,1038460,7126002
7647,"Croc Blanc",2018,0,7122668,7122668
7648,"Hardbodies",1984,7121000,0,7121000
7649,"Gekijouban Kamen raidâ Doraibu: Sapuraizu fyûch…",2015,0,7118376,7118376
7650,"Confidences trop intimes",2004,2106677,5010350,7117027
7651,"Dear God",1996,7114089,0,7114089
7652,"Phantom of the Opera at the Royal Albert Hall",2012,0,7106631,7106631
7653,"Sheng Si Lian",2015,0,7101276,7101276
7654,"Camille Redouble",2012,38243,7062461,7100704
7655,"Force 10 from Navarone",1978,7100000,0,7100000
7656,"Where Eagles Dare",1969,7100000,0,7100000
7657,"1492: Conquest of Paradise",1992,7099531,0,7099531
7658,"Kakushi toride no san akunin",2008,0,7095183,7095183
7659,"The Adventures of Pluto Nash",2002,4411102,2683893,7094995
7660,"Pride",2007,7057600,37050,7094650
7661,"Mak Dau Dong Dong Poon Ngo Sum",2017,0,7093313,7093313
7662,"Maggie’s Plan",2016,3351735,3739591,7091326
7663,"The September Issue",2009,3820700,3260982,7081682
7664,"Fuga de Cerebros 2",2011,0,7080080,7080080
7665,"Taras Bulba",2009,0,7077312,7077312
7666,"Croupier",2000,6201143,870000,7071143
7667,"Lemon Tree",2009,569672,6500000,7069672
7668,"Tsuioku",2017,0,7065019,7065019
7669,"The Stunt Man",1980,7063886,0,7063886
7670,"A Melody to Remember",2016,41845,7021559,7063404
7671,"Seung Joi Nei Jor Yau",2017,0,7052423,7052423
7672,"Tinker Bell and the Great Fairy Rescue",2010,0,7043631,7043631
7673,"BASEketball",1998,7042541,0,7042541
7674,"Rescue Dawn",2007,5490423,1547463,7037886
7675,"Sin Nombre",2009,2536665,4499757,7036422
7676,"The Adventures of Bob & Doug McKenzie: Strange …",1983,7035618,0,7035618
7677,"La Cara Oculta",2012,0,7033931,7033931
7678,"Dead Calm",1989,7032915,0,7032915
7679,"Marie-Francine",2017,0,7026711,7026711
7680,"Laaga Chunari Mein Daag",2007,675102,6350824,7025926
7681,"Three Wishes",1995,7025496,0,7025496
7682,"Les Innocentes",2016,1065665,5956909,7022574
7683,"An American Carol",2008,7013191,8992,7022183
7684,"Hiding Out",1987,7019441,0,7019441
7685,"Maybe Baby",2001,19147,7000000,7019147
7686,"Goon",2012,4164911,2853692,7018603
7687,"Harley Davidson and the Marlboro Man",1991,7018525,0,7018525
7688,"Veer-Zaara",2004,2938532,4079327,7017859
7689,"Grießnockerlaffäre",2017,0,7017501,7017501
7690,"Purikyua Supa Sutazu!",2018,0,7017326,7017326
7691,"Un Natale stupefacente",2014,0,7015989,7015989
7692,"Star Kid",1998,7015240,0,7015240
7693,"Eraserhead",1977,7000000,14590,7014590
7694,"Chotto Imakara Shigoto Yametekuru",2017,0,7012018,7012018
7695,"Bound",1996,3802260,3209057,7011317
7696,"Crossover",2006,7009668,0,7009668
7697,"Last of the Dogmen",1995,7008542,0,7008542
7698,"Yeomlyeok",2018,0,7001564,7001564
7699,"The Sugarland Express",1974,7000000,0,7000000
7700,"I Want To Live!",1958,7000000,0,7000000
7701,"The Trouble with Harry",1955,7000000,0,7000000
7702,"Smokey and the Bandit III",1983,7000000,0,7000000
7703,"The Fifth Floor",1978,7000000,0,7000000
7704,"The Funhouse",1981,7000000,0,7000000
7705,"The Great Santini",1979,7000000,0,7000000
7706,"Strangers on a Train",1951,7000000,0,7000000
7707,"Fatso",1980,7000000,0,7000000
7708,"The Prisoner of Zenda",1979,7000000,0,7000000
7709,"Garden of Evil",1954,7000000,0,7000000
7710,"Marnie",1964,7000000,0,7000000
7711,"Topkapi",1964,7000000,0,7000000
7712,"Raise the Titanic",1980,7000000,0,7000000
7713,"Spellbound",1945,7000000,0,7000000
7714,"Wasabi",2002,81525,6918475,7000000
7715,"Alphabet City",1984,7000000,0,7000000
7716,"Klovn Forever",2015,5700,6993521,6999221
7717,"Arn - Riket vid vägens slut",2008,0,6998907,6998907
7718,"Jessabelle",2014,0,6998359,6998359
7719,"Treintona Soltera y Fantástica",2016,0,6998219,6998219
7720,"Le mystère Henri Pick",2019,0,6996200,6996200
7721,"Relentless",1989,6985999,0,6985999
7722,"Screwed",2000,6982680,0,6982680
7723,"Innocent Voices",2005,837878,6144281,6982159
7724,"Kôdaike no hitobito",2016,0,6978689,6978689
7725,"Microcosmos",1996,1573842,5400000,6973842
7726,"Trial by Jury",1994,6971777,0,6971777
7727,"Fearless",1993,6971266,0,6971266
7728,"I Ought to be in Pictures",1982,6968359,0,6968359
7729,"Class of 1984",1982,6965361,0,6965361
7730,"Stick",1985,6964734,0,6964734
7731,"Ore Monogatari!!",2015,0,6962989,6962989
7732,"Paragraf 78",2007,0,6962393,6962393
7733,"You I Love",2018,0,6961334,6961334
7734,"Wolyn",2016,0,6960645,6960645
7735,"Shag",1989,6957975,0,6957975
7736,"Sage femme",2017,603582,6352310,6955892
7737,"Bo chi tung wah ",2008,0,6953637,6953637
7738,"Children of the Corn II: The Final Sacrifice",1993,6953340,0,6953340
7739,"Haunted 3-D",2011,0,6952492,6952492
7740,"Suburban Commando",1991,6948859,0,6948859
7741,"Strange Wilderness",2008,6575282,371802,6947084
7742,"L'heure d'été",2009,1647001,5300000,6947001
7743,"Blue City",1986,6947000,0,6947000
7744,"Sunadokei",2008,0,6943948,6943948
7745,"Perfectos desconocidos",2018,1014507,5924897,6939404
7746,"Le Retour du Héros",2018,37108,6902014,6939122
7747,"Rebelles",2019,0,6935403,6935403
7748,"Dead Bang",1989,6935216,0,6935216
7749,"The Wedding Banquet",1993,6933000,0,6933000
7750,"Rascals",2011,261156,6665133,6926289
7751,"The Awakening",2012,95933,6828388,6924321
7752,"One Chance",2013,90592,6827422,6918014
7753,"The Spectacular Now",2013,6852971,63980,6916951
7754,"Trapped",2002,6916869,0,6916869
7755,"Hagetaka",2009,0,6915788,6915788
7756,"A Cry in the Dark",1988,6908797,0,6908797
7757,"Red Sonja",1985,6905861,2779,6908640
7758,"House Arrest",1996,6906987,0,6906987
7759,"Paper Planes",2015,0,6887687,6887687
7760,"McDull: Me & My Mum",2014,0,6885569,6885569
7761,"Resturlaub",2011,0,6883237,6883237
7762,"Sabaibaru famirî",2017,0,6882845,6882845
7763,"Willard",2003,6882696,0,6882696
7764,"Gekijoban Naruto: Buraddo Purizun",2011,0,6881888,6881888
7765,"Redline",2007,6881021,0,6881021
7766,"Death Wish 4: The Crackdown",1987,6880310,0,6880310
7767,"Woman Thou Art Loosed",2004,6879730,0,6879730
7768,"Forushande",2016,2402067,4464863,6866930
7769,"Cosmopolis",2012,743636,6116988,6860624
7770,"200 Cigarettes",1999,6852450,0,6852450
7771,"The Map Against the World",2016,32893,6818555,6851448
7772,"Never Talk to Strangers",1995,6849998,0,6849998
7773,"Proud of Me",2018,0,6849959,6849959
7774,"Un'Estate al mare",2008,0,6845033,6845033
7775,"Panther",1995,6834000,0,6834000
7776,"Namastey London",2007,1207007,5624062,6831069
7777,"Moonlight Mile",2002,6830957,0,6830957
7778,"Da Wu Sheng",2011,35986,6791088,6827074
7779,"Carriers",2009,120866,6704531,6825397
7780,"Starbuck",2011,3790059,3034560,6824619
7781,"GG Bond: Guarding",2017,0,6821075,6821075
7782,"Prooi",2016,0,6820238,6820238
7783,"Blood Father",2016,0,6820000,6820000
7784,"Timbuktu",2014,1076075,5739746,6815821
7785,"Exit to Eden",1994,6813570,0,6813570
7786,"Bran Nue Dae",2010,113568,6698962,6812530
7787,"Apocalypse Code",2007,0,6811168,6811168
7788,"Beoning",2018,719772,6089953,6809725
7789,"Red Dog: True Blue",2016,0,6807689,6807689
7790,"The Chipmunk Adventure",1987,6804312,0,6804312
7791,"The Train",1965,6800000,0,6800000
7792,"Runaway",1984,6800000,0,6800000
7793,"Hang 'em High",1968,6800000,0,6800000
7794,"Easter Parade",1948,6800000,0,6800000
7795,"Nos Jours Heureux",2006,0,6793108,6793108
7796,"Tulip Fever",2017,2455635,4337133,6792768
7797,"Black and White",2008,0,6789166,6789166
7798,"Der Kleine Drache Kokosnuss",2014,0,6789049,6789049
7799,"The Road Home",2001,1280090,5500000,6780090
7800,"Autómata",2014,0,6775458,6775458
7801,"Nie klam, kochanie",2008,0,6773855,6773855
7802,"Suspiria",2018,2483472,4289583,6773055
7803,"The Tall Man",2012,0,6770790,6770790
7804,"Minuscule - Les mandibules du bout du monde",2019,0,6767603,6767603
7805,"October",2018,0,6766408,6766408
7806,"Jai Simha",2018,0,6763950,6763950
7807,"Caught Up",1998,6754958,7703,6762661
7808,"A Mulher Invisível",2009,0,6762276,6762276
7809,"Renoir",2012,2291047,4470589,6761636
7810,"En man som heter Ove",2016,3479315,3279854,6759169
7811,"Just Getting Started",2017,6069605,686807,6756412
7812,"Top Cat",2011,0,6756182,6756182
7813,"The Forsaken",2001,6755271,0,6755271
7814,"The Winner",2015,0,6750000,6750000
7815,"Seraphin un Homme et Son",2002,6749187,0,6749187
7816,"Bana Masal Anlatma",2015,0,6740968,6740968
7817,"Nine 1/2 Weeks",1986,6734844,0,6734844
7818,"Huai Dan Bi Xu Si",2015,0,6733311,6733311
7819,"Kenny",2008,69221,6662831,6732052
7820,"Reckless",1984,6731602,0,6731602
7821,"De Storm",2009,0,6730513,6730513
7822,"Tamara Drewe",2010,560391,6167359,6727750
7823,"Victoria",2015,6971,6718979,6725950
7824,"Soosanghan Gogaekdeul",2011,0,6720920,6720920
7825,"Into the Night",1985,6720160,0,6720160
7826,"American History X",1998,6719864,0,6719864
7827,"Bu neng shuo de mi mi",2008,0,6718385,6718385
7828,"Mon roi",2015,54114,6659487,6713601
7829,"Roger & Me",1989,6706368,0,6706368
7830,"Hanni Und Nanni 3",2013,0,6704690,6704690
7831,"Comin' at Ya!",1981,6704127,0,6704127
7832,"El Infierno",2010,0,6703873,6703873
7833,"The Aristocrats",2005,6377461,325143,6702604
7834,"Heosamgwan maehyeolgi",2015,0,6702181,6702181
7835,"Till the Clouds Roll By",1947,6700000,0,6700000
7836,"Swing Shift",1984,6700000,0,6700000
7837,"The Mambo Kings",1992,6698607,0,6698607
7838,"U-Turn",1997,6690074,0,6690074
7839,"The Good German",2006,1308696,5369337,6678033
7840,"Le Placard",2001,6671454,0,6671454
7841,"Nightmares",1983,6670680,0,6670680
7842,"Mixed Nuts",1994,6670176,0,6670176
7843,"Pupille",2018,0,6668519,6668519
7844,"Six Weeks",1982,6668025,0,6668025
7845,"Where the Buffalo Roam",1980,6659377,0,6659377
7846,"Kill the Messenger",2014,2450846,4205859,6656705
7847,"Fahrenheit 11/9",2018,6352306,301409,6653715
7848,"Eipuriru fûruzu",2015,0,6652777,6652777
7849,"Meow",2017,0,6651494,6651494
7850,"Las brujas de Zugarramurdi",2013,0,6650778,6650778
7851,"Un conte de Noël",2008,1060922,5587717,6648639
7852,"Di jiu tian chang",2019,0,6646205,6646205
7853,"Apne",2007,0,6643574,6643574
7854,"Hanni und Nanni 2",2012,0,6642831,6642831
7855,"Bing He Zhui Xiong",2016,0,6640736,6640736
7856,"Fresh Horses",1988,6640346,0,6640346
7857,"Black Moon Rising",1986,6637565,0,6637565
7858,"Jannat",2008,30316,6604366,6634682
7859,"Almost An Angel",1990,6633976,0,6633976
7860,"It's Kind of a Funny Story",2010,6363628,269322,6632950
7861,"Sachin",2017,0,6630190,6630190
7862,"The Big Bounce",2004,6471394,154721,6626115
7863,"Johnny Handsome",1989,6622465,0,6622465
7864,"The Gong Show Movie",1980,6621520,0,6621520
7865,"Swingers",1996,4505922,2112656,6618578
7866,"Das Pubertier",2017,0,6618024,6618024
7867,"Duets",2000,4734235,1881217,6615452
7868,"Shubh Mangal Saavdhan",2017,511875,6102211,6614086
7869,"Southside with You",2016,6304223,308745,6612968
7870,"Mariages!",2004,0,6609909,6609909
7871,"The Golden Seal",1983,6609870,0,6609870
7872,"Unlocked",2017,0,6607476,6607476
7873,"Bleed for This",2016,5083906,1520020,6603926
7874,"China: The Panda Adventure",2001,3708478,2893265,6601743
7875,"The Razor's Edge",1984,6600000,0,6600000
7876,"Donovan's Reef",1963,6600000,0,6600000
7877,"Wish I Was Here",2014,3591299,3000066,6591365
7878,"Grandma’s Boy",2006,6090172,500000,6590172
7879,"BTS World Tour: Love Yourself in Seoul",2019,0,6587004,6587004
7880,"Copying Beethoven",2006,355968,6230356,6586324
7881,"North",1994,6583223,0,6583223
7882,"La Tortue Rouge",2016,920057,5662542,6582599
7883,"I Capture the Castle",2003,1174139,5407306,6581445
7884,"O Chem Govoryat Muzhchiny Prodolzhenie",2018,0,6577468,6577468
7885,"La mafia uccide solo d'estate",2013,37134,6539089,6576223
7886,"Yu-Gi-Oh!: The Dark Side of Dimensions",2016,0,6573390,6573390
7887,"Gekijoban Kamen Raida Kiba Makaijo no O",2008,0,6569478,6569478
7888,"Post Grad",2009,6382178,181224,6563402
7889,"D.A.R.Y.L.",1985,6561653,0,6561653
7890,"All Inclusive",2018,0,6559825,6559825
7891,"Trash",2015,17484,6535702,6553186
7892,"Lost and Found",1999,6552255,0,6552255
7893,"Blood and Chocolate",2007,3526588,3024722,6551310
7894,"Soorma",2018,382104,6168605,6550709
7895,"Zhu Zhu Xia 2",2015,0,6550000,6550000
7896,"Rough Cut",2008,0,6547719,6547719
7897,"Closed Circuit",2013,5750995,796531,6547526
7898,"Un + Une",2015,0,6546071,6546071
7899,"Days of Our Own",2016,0,6545251,6545251
7900,"Mother and Child",2010,1110509,5426670,6537179
7901,"Life Itself",2018,4095431,2438016,6533447
7902,"Piranha 3DD",2012,370904,6159892,6530796
7903,"Kakekomi onna to kakedashi otoko",2015,0,6528543,6528543
7904,"Lucky You",2007,5755286,766543,6521829
7905,"Günesi Gördüm",2009,0,6514227,6514227
7906,"Nevesta",2017,0,6505959,6505959
7907,"Switchback",1997,6504442,0,6504442
7908,"Bom yeoreum gaeul gyeoul geurigo bom",2004,2380788,4121576,6502364
7909,"En solitaire",2013,103628,6397101,6500729
7910,"I'll Cry Tomorrow",1955,6500000,0,6500000
7911,"High Society",1956,6500000,0,6500000
7912,"The Osterman Weekend",1983,6500000,0,6500000
7913,"Teacher's Pet: The Movie",2004,6491969,0,6491969
7914,"Todos Queremos a Alguien",2017,1915789,4575596,6491385
7915,"The Road to Wellville",1994,6487257,0,6487257
7916,"The Real McCoy",1993,6484246,0,6484246
7917,"Amy",2001,7880,6475545,6483425
7918,"Final Fantasy XV: Kingsglaive",2016,269980,6210000,6479980
7919,"Ferrari Ki Sawaari",2012,420046,6056990,6477036
7920,"Flashback",1990,6476134,0,6476134
7921,"Star 80",1983,6472990,0,6472990
7922,"Ôtez-moi d'un Doute",2017,0,6467372,6467372
7923,"Les nouvelles aventures de Cendrillon",2017,0,6466643,6466643
7924,"Race 3",2018,1690861,4773496,6464357
7925,"The Happy Life",2007,0,6463745,6463745
7926,"Mio Fratello è Figlio Unico",2008,255620,6207666,6463286
7927,"The Good Thief",2003,3517797,2942961,6460758
7928,"Attack the Block",2011,1024175,5435008,6459183
7929,"Delibal",2015,0,6457519,6457519
7930,"Kawaki",2014,16627,6440852,6457479
7931,"28 panfilovtsev",2016,0,6457240,6457240
7932,"The Last Unicorn",1982,6455330,0,6455330
7933,"Tu seras mon fils",2012,203636,6249895,6453531
7934,"Gods and Monsters",1998,6451628,0,6451628
7935,"Twelve O'Clock High",1949,6450000,0,6450000
7936,"Warriors of Virtue",1997,6448817,0,6448817
7937,"Waiting for Superman",2010,6417135,28931,6446066
7938,"Tsuma yo bara no yô ni: Kazoku wa tsuraiyo III",2018,0,6438585,6438585
7939,"High Tension",2005,3681066,2754196,6435262
7940,"Deliha 2",2018,0,6429949,6429949
7941,"Against the Ropes",2004,5881504,548361,6429865
7942,"Wonderful Nightmare",2015,0,6426388,6426388
7943,"S: The Last Policeman: Recovery of Our Future",2015,0,6425190,6425190
7944,"Dear Tutu",2017,0,6425179,6425179
7945,"Feel the Noise",2007,5867786,556209,6423995
7946,"Same Kind of Different as Me",2017,6423605,0,6423605
7947,"The Hunted",1995,6420615,0,6420615
7948,"Il Divo",2009,240159,6179934,6420093
7949,"The Temp",1993,6419876,0,6419876
7950,"Cantinflas",2014,6382924,31830,6414754
7951,"Just Between Friends",1986,6408791,0,6408791
7952,"Goryeonghwa Gajok",2013,0,6404951,6404951
7953,"La loi du marché",2015,112391,6291988,6404379
7954,"Nada SoSo",2006,0,6402070,6402070
7955,"My Own Private Idaho",1991,6401336,0,6401336
7956,"Run the Race",2019,6400684,0,6400684
7957,"Eyewitness",1981,6400000,0,6400000
7958,"Michiel de Ruyter",2015,0,6398807,6398807
7959,"Kamen raidâ Heisei jenerêshonzu: Dr. Pakkuman t…",2016,0,6394531,6394531
7960,"Andel Páne 2",2016,0,6387619,6387619
7961,"Battle for Terra",2009,1647083,4740415,6387498
7962,"Polícia Federal: A Lei é Para Todos",2017,0,6382550,6382550
7963,"Transsiberian",2008,2203641,4175934,6379575
7964,"Defenseless",1991,6379362,0,6379362
7965,"Narzeczony na Niby",2018,0,6379141,6379141
7966,"Ned Kelly",2004,86959,6284940,6371899
7967,"The Opposite of Sex",1998,6367164,0,6367164
7968,"Larguées",2018,0,6367018,6367018
7969,"Funôhan",2018,0,6356312,6356312
7970,"Shinjuku Suwan II",2017,0,6355297,6355297
7971,"Changing Partners",2007,0,6348194,6348194
7972,"Charming",2018,0,6347473,6347473
7973,"The Sting II",1983,6347072,0,6347072
7974,"L’écume des jours",2013,303187,6040048,6343235
7975,"Most Wanted",1997,6343015,0,6343015
7976,"Motel Hell",1980,6342668,0,6342668
7977,"Pirates",1986,1641825,4700000,6341825
7978,"Amityville 3-D",1983,6333135,0,6333135
7979,"Honnouji hoteru",2017,0,6330984,6330984
7980,"Affliction",1998,6330054,0,6330054
7981,"Joe Kidd",1972,6330000,0,6330000
7982,"Knock Knock",2015,36336,6292180,6328516
7983,"Girls Just Want to Have Fun",1985,6326051,0,6326051
7984,"Kizumonogatari: I Tekketsu-hen",2016,0,6324508,6324508
7985,"Inside or Outside (China)",2016,0,6323457,6323457
7986,"Deja Vu",1998,821997,5500000,6321997
7987,"Little Miss Marker",1980,6321392,0,6321392
7988,"Dragon Force-Rise of Ultraman",2019,0,6319362,6319362
7989,"Kukhnya Poslednyaya Bitva",2017,0,6313761,6313761
7990,"Jalouse",2017,0,6303104,6303104
7991,"Faet",2007,0,6301481,6301481
7992,"Fei tian",2011,0,6301200,6301200
7993,"A Sound of Thunder",2005,1900451,4400000,6300451
7994,"Alice's Restaurant",1969,6300000,0,6300000
7995,"The Adventures of Buckaroo Banzai Across the 8t…",1984,6300000,0,6300000
7996,"Dil Bole Hadippa!",2009,351457,5944563,6296020
7997,"Jab We Met",2007,0,6295513,6295513
7998,"What Planet Are You From?",2000,6291602,0,6291602
7999,"Os Parças",2017,0,6290388,6290388
8000,"Six Degrees of Separation",1993,6284090,0,6284090
8001,"Fünf Freunde 4",2015,0,6283154,6283154
8002,"Pitbull. Ostatni Pies",2018,0,6282750,6282750
8003,"Gloria Bell",2019,5410222,872343,6282565
8004,"Shi Quan Jiu Mei",2008,0,6282049,6282049
8005,"Article 99",1992,6281089,0,6281089
8006,"Dick",1999,6276869,0,6276869
8007,"Kobiety mafii 2",2019,0,6276042,6276042
8008,"Illang: The Wolf Brigade",2018,0,6272692,6272692
8009,"Contre-Enquete",2008,11846,6260708,6272554
8010,"Rambling Rose",1991,6266621,0,6266621
8011,"A Night in the Life of Jimmy Reardon",1988,6264058,0,6264058
8012,"Music Box",1989,6263883,0,6263883
8013,"Bizim Için Sampiyon",2018,0,6252450,6252450
8014,"Verónica",2017,0,6252233,6252233
8015,"Deuces Wild",2002,6044618,200000,6244618
8016,"Widow's Peak",1994,6243722,0,6243722
8017,"Zhu Zhu Xia Zhi Ying Xiong Zhu Shao Nian",2017,0,6240000,6240000
8018,"Oldboy",2003,707391,5532332,6239723
8019,"Loro 1",2018,0,6227489,6227489
8020,"Görümce",2016,0,6225902,6225902
8021,"Harsh Times",2006,3337931,2887373,6225304
8022,"En liberté!",2018,0,6223716,6223716
8023,"Seer",2011,0,6223500,6223500
8024,"Phoenix",2015,3166858,3056173,6223031
8025,"The House of the Spirits",1994,6217413,0,6217413
8026,"Salineuiloe",2015,0,6217271,6217271
8027,"Unbroken: Path to Redemption",2018,6216897,0,6216897
8028,"Oh Heavenly Dog",1980,6216067,0,6216067
8029,"The Van",1997,621093,5592945,6214038
8030,"Rabbit Hole",2010,2229058,3975976,6205034
8031,"Ils se marièrent et eurent beaucoup d'enfants (…",2005,252341,5952125,6204466
8032,"CitizenFour",2014,2800870,3401898,6202768
8033,"Night and the City",1992,6202756,0,6202756
8034,"Topsy Turvy",1999,6201757,0,6201757
8035,"Firstborn",1984,6200000,0,6200000
8036,"Pennies from Heaven",1981,6200000,0,6200000
8037,"Celebrity",1998,5078660,1121340,6200000
8038,"The Straight Story",1999,6197866,0,6197866
8039,"El Cartel De Los Sapos",2012,0,6197324,6197324
8040,"Lowriders",2017,6179955,8466,6188421
8041,"É Fada!",2016,0,6186539,6186539
8042,"College",2008,4694491,1481623,6176114
8043,"Almost Heroes",1998,6175688,0,6175688
8044,"Kocan Kadar Konus Dirilis",2016,0,6174554,6174554
8045,"Nowhere in Africa",2003,6173485,0,6173485
8046,"Do Knot Disturb",2009,213525,5959859,6173384
8047,"Ma reum",2018,0,6170982,6170982
8048,"Wo Di Ju Xing",2018,0,6168544,6168544
8049,"Aisha",2010,298431,5867214,6165645
8050,"Bel Ami",2012,120462,6044657,6165119
8051,"UHF",1989,6157157,0,6157157
8052,"Delta Force 2",1990,6154944,0,6154944
8053,"The Fifth Estate",2013,3254172,2900000,6154172
8054,"The Autopsy of Jane Doe",2016,0,6152973,6152973
8055,"Peppa Pig My First Cinema Experience: Peppa's A…",2017,0,6150270,6150270
8056,"Chained Heat",1983,6149983,0,6149983
8057,"Banghwanghaneun Kalnel",2014,0,6148888,6148888
8058,"Babushka lyogkogo povedeniya",2017,0,6142164,6142164
8059,"Mystery Date",1991,6141446,0,6141446
8060,"The Pope of Greenwich Village",1984,6139896,0,6139896
8061,"Horrid Henry: The Movie",2013,0,6136575,6136575
8062,"Podatek od Milosci",2018,0,6134744,6134744
8063,"Learning to Drive",2015,3447633,2684931,6132564
8064,"The Soldier",1982,6123549,0,6123549
8065,"The Mighty",1998,2652246,3469336,6121582
8066,"Gang Tie Fei Long Zhi Zai Jian Ao Te Man",2017,0,6120728,6120728
8067,"Stand Up Guys",2013,3310031,2808766,6118797
8068,"The Border",1982,6118683,0,6118683
8069,"The Killing of a Sacred Deer",2017,2291900,3824019,6115919
8070,"London Boulevard",2011,16075,6095119,6111194
8071,"Short Cuts",1993,6110979,0,6110979
8072,"Plenty",1985,6104212,0,6104212
8073,"The Door in the Floor",2004,3835551,2267279,6102830
8074,"The Secret of Roan Inish",1995,6101815,0,6101815
8075,"Un Padre No Tan Padre",2016,2156047,3945457,6101504
8076,"Il buono, il brutto, il cattivo",1967,6100000,0,6100000
8077,"Whose Life is it Anyway?",1981,6100000,0,6100000
8078,"Dylan Dog: Dead of Night",2011,1186538,4907187,6093725
8079,"Gotti",2018,4286367,1802733,6089100
8080,"The Duelist",2016,0,6088454,6088454
8081,"Kull The Conqueror",1997,6086891,0,6086891
8082,"Se Dio vuole",2015,0,6084859,6084859
8083,"Vitus",2007,187480,5892076,6079556
8084,"The Secret Life of Words",2006,20678,6055437,6076115
8085,"Assassination",1987,6075793,0,6075793
8086,"A Good Woman",2006,223144,5852606,6075750
8087,"Hampstead",2017,0,6075322,6075322
8088,"Rosenstrasse",2004,732036,5341090,6073126
8089,"Heaven Help Us",1985,6070794,0,6070794
8090,"El Cuaderno de Sara",2018,0,6070039,6070039
8091,"Norman: The Moderate Rise and Tragic Fall of a …",2017,3814868,2254131,6068999
8092,"Men Don't Leave",1990,6050018,0,6050018
8093,"Meet the Mormons",2014,6047363,1808,6049171
8094,"Megiddo: Omega Code 2",2001,6047691,0,6047691
8095,"Best of the Best 2",1993,6044652,0,6044652
8096,"Mi obra maestra",2018,0,6038590,6038590
8097,"Kabei: Our Mother",2009,14416,6018714,6033130
8098,"Frozen River",2008,2511476,3518653,6030129
8099,"The Limey",1999,3193102,2836945,6030047
8100,"A Fine Mess",1986,6029824,0,6029824
8101,"If Only",2004,0,6027849,6027849
8102,"Foolish",1999,6026908,0,6026908
8103,"Das kleine Gespenst",2013,0,6024589,6024589
8104,"Trapped in Paradise",1994,6017509,0,6017509
8105,"La fille de Monaco",2009,602992,5413449,6016441
8106,"The Walking Dead",1995,6014340,0,6014340
8107,"Matru ki Bijlee ka Mandola",2013,0,6009116,6009116
8108,"Break Ke Baad",2010,427628,5576510,6004138
8109,"The Truth About Charlie",2002,5303000,700000,6003000
8110,"Rebecca",1940,6000000,2370,6002370
8111,"Timerider: The Adventure of Lyle Swann",1982,6000000,0,6000000
8112,"Wanted: Dead or Alive",1987,6000000,0,6000000
8113,"Thunder & Lightning",1977,6000000,0,6000000
8114,"Trick or Treat",1986,6000000,0,6000000
8115,"Woman of the Year",1942,6000000,0,6000000
8116,"The Unholy",1988,6000000,0,6000000
8117,"Simon",1980,6000000,0,6000000
8118,"El Dorado",1967,6000000,0,6000000
8119,"The Seven Year Itch",1955,6000000,0,6000000
8120,"The Mountain Men",1980,6000000,0,6000000
8121,"Man's Favorite Sport?",1964,6000000,0,6000000
8122,"Mac and Me",1988,6000000,0,6000000
8123,"Topaz",1969,6000000,0,6000000
8124,"Dragonslayer",1981,6000000,0,6000000
8125,"Dial M for Murder",1954,6000000,0,6000000
8126,"Chisum",1970,6000000,0,6000000
8127,"The War Wagon",1967,6000000,0,6000000
8128,"Claudine",1974,6000000,0,6000000
8129,"Braddock: Missing in Action III",1988,6000000,0,6000000
8130,"The Fortune Cookie",1966,6000000,0,6000000
8131,"The Grass is Greener",1960,6000000,0,6000000
8132,"The Group",1966,6000000,0,6000000
8133,"Heartbeeps",1981,6000000,0,6000000
8134,"Hot to Trot",1988,6000000,0,6000000
8135,"How to Become a Detective",1936,6000000,0,6000000
8136,"How to Succeed in Business Without Really Trying",1967,6000000,0,6000000
8137,"If It's Tuesday, This Must Be Belgium",1969,6000000,0,6000000
8138,"Captain Horatio Hornblower R.N.",1951,6000000,0,6000000
8139,"Marjorie Morningstar",1958,6000000,0,6000000
8140,"The Shootist",1975,6000000,0,6000000
8141,"Apache",1954,6000000,0,6000000
8142,"American Pop",1981,6000000,0,6000000
8143,"Pandas",2018,5757906,231452,5989358
8144,"The Trip to Italy",2014,2873758,3110849,5984607
8145,"1969",1988,5979011,0,5979011
8146,"8 novykh svidaniy",2015,0,5977612,5977612
8147,"Les Boys II",1998,5974732,0,5974732
8148,"Neproshchennyy",2018,0,5969570,5969570
8149,"Lo Chiamavano Jeeg Robot",2016,0,5969047,5969047
8150,"Samsara",2012,2672413,3294258,5966671
8151,"The Devil's Double",2011,1361512,4604134,5965646
8152,"Legendary Amazons",2012,0,5959716,5959716
8153,"My Little Pony: The Movie",1986,5958456,0,5958456
8154,"Dhan Dhana Dhan Goal",2007,125547,5832212,5957759
8155,"Tie Mu Zhen Chuan Shuo",2018,0,5957524,5957524
8156,"La Première étoile",2009,0,5955923,5955923
8157,"Daikessen! Cho Urutora Hachi Kyodai",2008,0,5954671,5954671
8158,"The Return",2004,501752,5452134,5953886
8159,"Tantei Wa Bar Ni Iru 2",2013,0,5951523,5951523
8160,"Severance",2007,137221,5812781,5950002
8161,"Kolpaçino 3. Devre",2016,0,5949881,5949881
8162,"She's Funny That Way",2015,111993,5834649,5946642
8163,"Krazzy 4",2008,487215,5457967,5945182
8164,"Slackers",2002,4814244,1127974,5942218
8165,"All Saints",2017,5802208,139786,5941994
8166,"Kyonen no fuyu, kimi to wakare",2018,0,5941231,5941231
8167,"Uchu no Ho: Reimei-hen",2018,0,5937936,5937936
8168,"Mere Baap Pehle Aap",2008,113576,5824123,5937699
8169,"Evil Dead II",1987,5923044,3133,5926177
8170,"Inventing the Abbotts",1997,5926128,0,5926128
8171,"Adulthood",2008,0,5922805,5922805
8172,"Fish Tank",2010,374675,5547617,5922292
8173,"How Are You",2017,0,5921481,5921481
8174,"Deok Gaai",2017,0,5919976,5919976
8175,"The Touch",2004,0,5918742,5918742
8176,"Wazir",2016,586028,5331841,5917869
8177,"Yol Arkadasim",2017,0,5910170,5910170
8178,"Gang Related",1997,5906773,0,5906773
8179,"Folks!",1992,5906300,0,5906300
8180,"Krym",2017,0,5904389,5904389
8181,"Un moment d'égarement",2015,0,5902504,5902504
8182,"Ask Sana Benzer",2015,0,5902324,5902324
8183,"The Boxer",1997,5896037,0,5896037
8184,"Oboreru naifu",2016,0,5895838,5895838
8185,"Moschettieri del Re - La penultima missione",2018,0,5895366,5895366
8186,"Die Vampirschwestern 3",2016,0,5894544,5894544
8187,"True Story",2015,4719695,1174515,5894210
8188,"20 Feet From Stardom",2013,4946250,946216,5892466
8189,"Death of a Nation",2018,5885881,0,5885881
8190,"Barbara",2012,0,5882696,5882696
8191,"Milano-Palermo: il ritorno",2007,0,5871643,5871643
8192,"Light It Up",1999,5871603,0,5871603
8193,"Zhai Nu Gui Xiang",2015,0,5860000,5860000
8194,"Olanlar Oldu",2017,0,5859771,5859771
8195,"Vsyo Mogut Koroli",2008,0,5858956,5858956
8196,"Last Dance",1996,5857534,0,5857534
8197,"The Rescue",1988,5855392,0,5855392
8198,"The Transformers: The Movie",1986,5849647,0,5849647
8199,"Un homme pressé",2018,0,5848333,5848333
8200,"Palmetto",1998,5846660,0,5846660
8201,"The Hitcher",1986,5844868,0,5844868
8202,"Immediate Family",1989,5841286,0,5841286
8203,"Heaven & Earth",1993,5840300,0,5840300
8204,"24 Hours to Live",2017,0,5840146,5840146
8205,"An Inconvenient Sequel",2017,3496795,2342527,5839322
8206,"Crossroads",1986,5839031,0,5839031
8207,"Kazoku wa Tsuraiyo 2",2017,0,5837844,5837844
8208,"Swiss Army Man",2016,4210454,1626657,5837111
8209,"Night of the Living Dead",1990,5835247,0,5835247
8210,"Kirakira Pretty Cure A La Mode the Movie",2017,0,5832342,5832342
8211,"The Last American Virgin",1982,5829781,0,5829781
8212,"Ed Wood",1994,5828466,0,5828466
8213,"SMS für Dich",2016,0,5828223,5828223
8214,"Coco Chanel and Igor Stravinsky",2010,1725982,4100000,5825982
8215,"Detroit Rock City",1999,4217115,1608199,5825314
8216,"Pororo, Dinosaur Island Adventure",2017,0,5824076,5824076
8217,"Yucatán",2018,0,5820928,5820928
8218,"Ma vie de Courgette",2016,309768,5511123,5820891
8219,"Stanley & Iris",1990,5820015,0,5820015
8220,"Intruders",2012,48366,5770061,5818427
8221,"Il professor Cenerentolo",2015,0,5818350,5818350
8222,"Hello Carbot the Movie: The Cretaceous Period",2018,0,5817041,5817041
8223,"The Perfect Holiday",2007,5812781,0,5812781
8224,"C'est quoi cette famille ?!",2016,0,5806807,5806807
8225,"Jab Tak Hai Jaan",2012,3047539,2759127,5806666
8226,"The Pact",2012,0,5804574,5804574
8227,"Isshuukan furenzu",2017,0,5804519,5804519
8228,"Jolly LLB",2013,0,5801422,5801422
8229,"Rio Bravo",1959,5800000,0,5800000
8230,"Sunny: Tsuyoi Kimochi Tsuyoi Ai",2018,0,5799863,5799863
8231,"Stritreysery",2008,0,5799137,5799137
8232,"The Skeleton Twins",2014,5284309,512883,5797192
8233,"Feast of Love",2007,3508572,2287895,5796467
8234,"Mona Lisa",1986,5794000,0,5794000
8235,"Last Cab to Darwin",2015,34193,5753713,5787906
8236,"Leseulleo",2018,0,5782988,5782988
8237,"Catch a Fire",2006,4299773,1482425,5782198
8238,"Sheena",1984,5778353,0,5778353
8239,"Callas Forever",2004,445996,5327134,5773130
8240,"Kolya",1997,5770254,0,5770254
8241,"Local Hero",1983,5767363,0,5767363
8242,"The Tie That Binds",1995,5762795,0,5762795
8243,"A Bigger Splash",2015,2024099,3735864,5759963
8244,"Heartbreak Hotel",2007,0,5758778,5758778
8245,"Ani ni aisaresugite komattemasu",2017,0,5758464,5758464
8246,"Phantoms",1998,5755333,0,5755333
8247,"Freche Mädchen",2008,0,5752203,5752203
8248,"The Last Seduction",1994,5751320,0,5751320
8249,"Ishqiya",2010,91468,5657920,5749388
8250,"Wo Shi Ni Ma",2018,0,5748970,5748970
8251,"One Eight Seven",1997,5747802,0,5747802
8252,"Happiness",1998,2746453,3000000,5746453
8253,"Won't Back Down",2012,5310554,434949,5745503
8254,"Patiala House",2011,644010,5096495,5740505
8255,"Comme un chef",2012,342667,5396323,5738990
8256,"Orlando",1992,5737353,0,5737353
8257,"Gallipoli",1981,5732587,0,5732587
8258,"Barton Fink",1991,5726463,0,5726463
8259,"A zori zdes tikhie...",2015,0,5726339,5726339
8260,"Millennium",1989,5725353,0,5725353
8261,"Elefante blanco",2012,8863,5715927,5724790
8262,"My Best Friend’s Wedding",2016,77043,5647639,5724682
8263,"Testament of Youth",2015,1822250,3900656,5722906
8264,"El crimen de padre Amaro",2002,5719000,0,5719000
8265,"Wisdom",1986,5715174,0,5715174
8266,"Surrender",1987,5711976,0,5711976
8267,"Kimi to 100 Kaime no Koi",2017,0,5710123,5710123
8268,"Trolljegeren",2011,253444,5453194,5706638
8269,"Anomalisa",2016,3759286,1946882,5706168
8270,"My New Sassy Girl",2016,0,5701519,5701519
8271,"Screamers",1996,5701359,0,5701359
8272,"Sorry, Wrong Number",1948,5700000,0,5700000
8273,"Under Fire",1983,5700000,0,5700000
8274,"Leatherface: Texas Chainsaw Massacre III",1990,5697588,0,5697588
8275,"Nounai poizun berî",2015,0,5697583,5697583
8276,"Carbone",2017,0,5696993,5696993
8277,"Who's Your Caddy?",2007,5694308,0,5694308
8278,"People I Know",2003,121972,5572241,5694213
8279,"Get on the Bus",1996,5691854,0,5691854
8280,"Gold Diggers: The Secret of Bear Mountain",1995,5691405,0,5691405
8281,"Before Sunrise",1995,5274005,416215,5690220
8282,"Kundun",1997,5686694,0,5686694
8283,"Dark Places",2015,208588,5477009,5685597
8284,"Blood: The Last Vampire",2009,256682,5427272,5683954
8285,"Cold Comfort Farm",1996,5682429,0,5682429
8286,"Eight Men Out",1988,5680515,0,5680515
8287,"Megaforce",1982,5675599,0,5675599
8288,"Down in the Delta",1998,5672903,0,5672903
8289,"Nadine",1987,5669831,0,5669831
8290,"Scoop!",2016,0,5669344,5669344
8291,"Heneral Luna",2015,206040,5459601,5665641
8292,"The Concrete Jungle",1982,5664557,0,5664557
8293,"Daeripgun",2017,84532,5579979,5664511
8294,"Kainan 1890",2015,0,5663664,5663664
8295,"Where the Money Is",2000,5658940,0,5658940
8296,"Uso wo aisuru onna",2018,0,5657262,5657262
8297,"Beyond Rangoon",1995,5656641,0,5656641
8298,"The Pallbearer",1996,5656388,0,5656388
8299,"Something Wicked This Way Comes",1983,5656087,0,5656087
8300,"Underclassman",2005,5654777,0,5654777
8301,"Sangryusahui",2018,0,5654305,5654305
8302,"Ledokol",2016,0,5653689,5653689
8303,"La Villa",2017,0,5652066,5652066
8304,"Hardware",1990,5649801,0,5649801
8305,"The Place",2017,0,5644602,5644602
8306,"Never Die Alone",2004,5644575,0,5644575
8307,"Lump of Sugar",2006,0,5641862,5641862
8308,"Neues Vom Wixxer",2007,0,5641431,5641431
8309,"Monsters",2010,237301,5402429,5639730
8310,"Yol Arkadasim 2",2018,0,5635291,5635291
8311,"Saengil",2019,0,5632640,5632640
8312,"Swing Kids",1993,5632086,0,5632086
8313,"The Eagle Huntress",2016,3168664,2462577,5631241
8314,"Ma che bella sorpresa",2015,0,5626528,5626528
8315,"Avenging Angel",1985,5622787,0,5622787
8316,"The Frozen Ground",2013,0,5617460,5617460
8317,"Batman: Mask of the Phantasm",1993,5617391,0,5617391
8318,"Man on Wire",2008,2962242,2654825,5617067
8319,"3D Sex and Zen: Extreme Ecstasy",2011,152365,5458536,5610901
8320,"¿Cómo Cortar a Tu Patan?",2017,0,5607900,5607900
8321,"Bbuddah: Hoga Tera Baap",2011,326011,5276693,5602704
8322,"Tales from the Crypt Presents: Bordello of Blood",1996,5601285,0,5601285
8323,"Streets of Fire",1984,5600000,0,5600000
8324,"Yellow Sky",1948,5600000,0,5600000
8325,"The Star Chamber",1983,5600000,0,5600000
8326,"Inuyashiki",2018,0,5598160,5598160
8327,"Tamara",2016,0,5595545,5595545
8328,"Jiang cuo jiu cuo",2015,0,5590000,5590000
8329,"Tantei wa bar ni iru 3",2017,0,5589299,5589299
8330,"The Cemetery Club",1993,5583621,0,5583621
8331,"Urfin Dzhyus I Yego Derevyannyye Soldaty",2017,0,5582912,5582912
8332,"Europa Europa",1991,5575738,0,5575738
8333,"Once Upon a Time in America",1984,5321508,254140,5575648
8334,"Ore wa, kimi no tame ni koso shini ni iku",2007,0,5575613,5575613
8335,"Gridlock'd",1997,5573929,0,5573929
8336,"Cesar Chavez",2014,5571497,0,5571497
8337,"Phillauri",2017,467596,5103302,5570898
8338,"Vice Squad",1982,5568880,0,5568880
8339,"Truth",2015,2541854,3026911,5568765
8340,"Walk of Shame",2014,59209,5506050,5565259
8341,"A Night in Heaven",1983,5563663,0,5563663
8342,"Space Chimps 2: Zartog Strikes Back",2010,0,5560200,5560200
8343,"Nicotina",2004,1109100,4450000,5559100
8344,"The Lookout",2007,4600585,954433,5555018
8345,"Mustang",2015,845464,4707120,5552584
8346,"For Your Consideration",2006,5549923,0,5549923
8347,"The Piper",2015,0,5546500,5546500
8348,"Me Gusta pero me Asusta",2017,0,5545026,5545026
8349,"Life",2015,0,5536354,5536354
8350,"The Brothers Bloom",2009,3531756,2000000,5531756
8351,"The Meddler",2016,4267219,1259723,5526942
8352,"C'est tout pour moi",2017,0,5521370,5521370
8353,"Invisible Target",2007,0,5520795,5520795
8354,"Aqua Teen Hunger Force Colon Movie Film for The…",2007,5520368,0,5520368
8355,"Wind",1992,5519569,0,5519569
8356,"Say It Isn't So",2001,5516708,0,5516708
8357,"Terra Formars",2016,0,5512622,5512622
8358,"Cash",2007,0,5512027,5512027
8359,"David Brent: Life on the Road",2016,0,5511343,5511343
8360,"Heartbreak Hotel",1988,5509417,0,5509417
8361,"Boku no kanojo wa saibôgu",2008,0,5506234,5506234
8362,"Tuo Dan Gao Ji",2018,0,5504562,5504562
8363,"Slums of Beverly Hills",1998,5502773,0,5502773
8364,"Across the Wide Missouri",1951,5500000,0,5500000
8365,"Love Addict",2018,0,5498768,5498768
8366,"Three of Hearts",1993,5495507,0,5495507
8367,"Five",2016,0,5491341,5491341
8368,"Somos Tao Jovens",2013,0,5490389,5490389
8369,"Ride",1998,5485295,0,5485295
8370,"Dalida",2017,2917,5482287,5485204
8371,"Educazione siberiana",2013,0,5483756,5483756
8372,"Unthinkable",2010,0,5483534,5483534
8373,"Di Ya Cao",2018,0,5483241,5483241
8374,"Joséphine s'arrondit",2016,0,5481186,5481186
8375,"Tucker & Dale vs. Evil",2011,223838,5252955,5476793
8376,"Made",2001,5308707,167353,5476060
8377,"Virgin Territory",2008,0,5473041,5473041
8378,"Mulgoe",2018,0,5468601,5468601
8379,"Collide",2016,2280004,3186694,5466698
8380,"Naqaab",2007,0,5461630,5461630
8381,"I Love That Crazy Little Thing",2016,0,5459981,5459981
8382,"Monkey Magic",2018,0,5458219,5458219
8383,"Copie conforme",2011,1373975,4081761,5455736
8384,"Mom",2017,0,5452492,5452492
8385,"Like for Likes",2016,50839,5393704,5444543
8386,"Precure All Stars The Movie: Everyone Sing Mira…",2016,0,5440957,5440957
8387,"Fathers and Daughters",2015,0,5439798,5439798
8388,"Martha Marcy May Marlene",2011,2981038,2457873,5438911
8389,"Heavenly Creatures",1994,3046086,2392034,5438120
8390,"Everybody Wants Some",2016,3400278,2036848,5437126
8391,"Livin' Large!",1991,5435488,0,5435488
8392,"Split Second",1992,5430822,0,5430822
8393,"Raees",2017,2369469,3059539,5429008
8394,"You Wan Mei Wan",2017,0,5428592,5428592
8395,"Arang",2006,0,5428407,5428407
8396,"Tango",1999,1687311,3741076,5428387
8397,"Birlesen Gonuller",2014,0,5427994,5427994
8398,"Black",2009,0,5424328,5424328
8399,"Human Traffic",2000,104257,5318483,5422740
8400,"Passion Fish",1992,5414619,0,5414619
8401,"Una Mujer sin Filtro",2018,0,5413420,5413420
8402,"Meatballs II",1984,5410972,0,5410972
8403,"Chiri tsubaki",2018,0,5410153,5410153
8404,"Monkeybone",2001,5409517,0,5409517
8405,"The Sicilian",1987,5406879,0,5406879
8406,"Sang-eui-won",2014,0,5406469,5406469
8407,"Dear White People",2014,4404154,999617,5403771
8408,"Koi wa ameagari no yô ni",2018,0,5403417,5403417
8409,"1612",2009,0,5400624,5400624
8410,"She Wore a Yellow Ribbon",1949,5400000,0,5400000
8411,"Racing with the Moon",1984,5400000,0,5400000
8412,"Diary of the Dead",2008,952620,4441827,5394447
8413,"October Baby",2012,5355847,36145,5391992
8414,"Predestination",2014,0,5386852,5386852
8415,"High-Rise",2016,346472,5033599,5380071
8416,"Once Upon a Time in the West",1969,5321508,56917,5378425
8417,"Rejsen til Saturn",2008,0,5377665,5377665
8418,"Sin Rodeos",2018,0,5377201,5377201
8419,"Umi yori mo mada fukaku",2016,272132,5093294,5365426
8420,"La Leyenda del Charro Negro",2018,0,5365299,5365299
8421,"The Show Must Go On",2007,0,5364079,5364079
8422,"A Guy Named Joe",1943,5363000,0,5363000
8423,"Wolves",1999,5361306,0,5361306
8424,"Ba La La Xiao Mo Xian Zhi Mo Jian Gong Zhu",2015,0,5360000,5360000
8425,"Yuvvraaj",2008,565440,4793674,5359114
8426,"The Boy",2015,0,5356447,5356447
8427,"One Night Only",2016,0,5350967,5350967
8428,"Hamlet",2015,0,5350452,5350452
8429,"Rocket Singh: Salesman of the Year",2009,164649,5184118,5348767
8430,"Equilibrium",2002,1190018,4155851,5345869
8431,"Chongtian Huo",2016,78377,5266978,5345355
8432,"Drona",2008,475104,4867185,5342289
8433,"Vollidiot",2007,0,5342096,5342096
8434,"L'Enfant",2006,651941,4689112,5341053
8435,"Wu Dang",2012,0,5340000,5340000
8436,"Den Vyborov",2007,0,5336377,5336377
8437,"La Cordillera",2017,0,5335438,5335438
8438,"Spooks: The Greater Good",2015,0,5328721,5328721
8439,"Il racconto dei racconti",2015,102186,5225313,5327499
8440,"Misseubaek",2018,0,5324020,5324020
8441,"L’étudiante et Monsieur Henri",2015,761,5319528,5320289
8442,"Marley",2012,1413480,3906254,5319734
8443,"Divine Madness!",1980,5318098,0,5318098
8444,"My War",2016,0,5316684,5316684
8445,"Tumhari Sulu",2017,0,5315502,5315502
8446,"Wild Target",2010,109338,5204856,5314194
8447,"The Proposition",2006,1903434,3410174,5313608
8448,"Non ci resta che il crimine",2019,0,5311875,5311875
8449,"Pane e tulipani",2001,5311177,0,5311177
8450,"Hot Pursuit",1987,4215859,1095016,5310875
8451,"The Dresser",1983,5310748,0,5310748
8452,"Dragon Tiger Gate",2006,0,5302904,5302904
8453,"Lost in the Pacific",2016,0,5301862,5301862
8454,"Metalstorm: The Destruction of Jared-Syn",1983,5301085,0,5301085
8455,"Ninas Mal",2007,0,5300000,5300000
8456,"Buddy Buddy",1981,5299037,0,5299037
8457,"Ironclad",2011,0,5297411,5297411
8458,"Charlie Bartlett",2008,3950294,1345615,5295909
8459,"CoeXister",2017,0,5295130,5295130
8460,"Yao",2019,0,5294564,5294564
8461,"Wendy",2017,0,5287776,5287776
8462,"Dhamaal",2007,166339,5117863,5284202
8463,"Michou D'Auber",2007,0,5278633,5278633
8464,"The Runaways",2010,3573673,1704959,5278632
8465,"Once Upon a Forest",1993,5274950,0,5274950
8466,"Ladron que roba a ladron",2007,4011254,1262012,5273266
8467,"San Francisco",1936,2868000,2405000,5273000
8468,"Devil's Pass",2013,0,5272302,5272302
8469,"Hear No Evil",1993,5270563,0,5270563
8470,"Love Letters",1984,5269990,0,5269990
8471,"Persuasion",1995,5269757,0,5269757
8472,"7 rzeczy, których nie wiecie o facetach",2016,0,5267920,5267920
8473,"No",2013,2341226,2924599,5265825
8474,"Anthropoid",2016,2963630,2301076,5264706
8475,"Gardens of Stone",1987,5262047,0,5262047
8476,"The Lost City",2006,2484186,2772653,5256839
8477,"Mr. Nian",2016,0,5256007,5256007
8478,"Shen Tan Jia Dao",2015,0,5252231,5252231
8479,"Hadi Insallah",2014,0,5251993,5251993
8480,"Normandie nue",2018,0,5251314,5251314
8481,"Une famille a louer",2015,0,5249634,5249634
8482,"Sivaji",2007,0,5246967,5246967
8483,"Lady Macbeth",2017,1129408,4115855,5245263
8484,"Indochine",1992,5243537,0,5243537
8485,"The Party",2017,749827,4493508,5243335
8486,"Black and White",2000,5241315,0,5241315
8487,"The Fog of War",2003,4198566,1035349,5233915
8488,"Gully Boy",2019,4216437,1016016,5232453
8489,"Siegfried & Roy: Masters of the Impossible",1999,5231283,0,5231283
8490,"Hollywood Shuffle",1987,5228617,0,5228617
8491,"El Fútbol o yo",2017,0,5220275,5220275
8492,"The In Crowd",2000,5217498,0,5217498
8493,"La Boda de Mi Mejor Amigo",2019,0,5217163,5217163
8494,"Il ragazzo invisibile",2014,0,5216102,5216102
8495,"In God We Tru$t",1980,5215015,0,5215015
8496,"The Crucifixion",2017,0,5214819,5214819
8497,"Le Capital",2012,22400,5186466,5208866
8498,"Balzac et la petite tailleuse chinoise",2005,665260,4543228,5208488
8499,"The Games Maker",2014,0,5205106,5205106
8500,"Formula 51",2002,5204007,0,5204007
8501,"Lovers of Six Years",2008,0,5202035,5202035
8502,"Ngok yan guk",2016,0,5201831,5201831
8503,"Jane Eyre",1996,5200601,0,5200601
8504,"The Yearling",1946,5200000,0,5200000
8505,"Tales of Manhattan",1942,5200000,0,5200000
8506,"Once Upon a Honeymoon",1942,5200000,0,5200000
8507,"The Comedians",1967,5200000,0,5200000
8508,"Kelly's Heroes",1970,5200000,0,5200000
8509,"Clara's Heart",1988,5194491,0,5194491
8510,"52 Pick-Up",1986,5186646,0,5186646
8511,"The Object of Beauty",1991,5186392,0,5186392
8512,"Sales Gosses",2017,0,5184002,5184002
8513,"Momo",2017,0,5181844,5181844
8514,"Born in the Exile: Sandaime J Soul Brothers no …",2016,0,5181032,5181032
8515,"Knock",2017,0,5180023,5180023
8516,"Le gamin au vélo",2012,1389524,3786899,5176423
8517,"Paris, je t'aime",2007,4857374,317714,5175088
8518,"Love, Rosie",2014,20431,5152883,5173314
8519,"Dream a Little Dream",1989,5171429,0,5171429
8520,"S.O.S.: Mulheres ao Mar 2",2015,0,5169793,5169793
8521,"Hitsuji no ki",2018,0,5168006,5168006
8522,"The Aftermath",2019,1565256,3601063,5166319
8523,"Underdog",2019,0,5165131,5165131
8524,"Mal de Pierres",2016,48677,5114004,5162681
8525,"Mein Blind Date mit dem Leben",2017,0,5161756,5161756
8526,"Da Nao Xi You",2018,0,5160000,5160000
8527,"Ba wang bie ji",1993,5158144,0,5158144
8528,"Brillantissime",2018,0,5154515,5154515
8529,"Les Beaux Gosses",2009,0,5152345,5152345
8530,"The House of Mirth",2000,3041803,2107328,5149131
8531,"Miseinen dakedo kodomo janai",2017,0,5146046,5146046
8532,"The Hotel New Hampshire",1984,5142858,0,5142858
8533,"Romantic Comedy",1983,5140538,0,5140538
8534,"Le silence de Lorna",2009,338795,4800000,5138795
8535,"Miles Ahead",2016,2610896,2506202,5117098
8536,"Grind",2003,5111630,0,5111630
8537,"Sugihara Chiune",2015,0,5108217,5108217
8538,"Gekijô-ban Kamen Raidâ Eguzeido: Tourû Endingu",2017,0,5107923,5107923
8539,"Action Point",2018,5059608,44067,5103675
8540,"La conquête",2011,74474,5028609,5103083
8541,"Dangerous Ground",1997,5102151,0,5102151
8542,"Of Mice and Men",1992,5101632,0,5101632
8543,"The Wildest Dream",2010,5100135,0,5100135
8544,"Out of Bounds",1986,5099316,0,5099316
8545,"Sobibor",2018,0,5096609,5096609
8546,"Sunshine",1999,5095981,0,5095981
8547,"A Royal Night Out",2015,228136,4866510,5094646
8548,"Vigilante",1983,5091888,0,5091888
8549,"Miami Rhapsody",1995,5086578,0,5086578
8550,"Selam: Bahara Yolculuk",2015,0,5075451,5075451
8551,"Aram Zam Zam, Ili Vsyo Vklyucheno",2011,0,5070293,5070293
8552,"Black Sheep",2007,82987,4980465,5063452
8553,"Being Flynn",2012,540152,4519704,5059856
8554,"Suburra",2015,0,5055019,5055019
8555,"Kurîpî: Itsuwari no rinjin",2016,0,5052951,5052951
8556,"Mes amis, mes amours",2008,0,5051954,5051954
8557,"Two Mules for Sister Sara",1970,5050000,0,5050000
8558,"Exotica",1994,5046118,0,5046118
8559,"The Beaver",2011,970816,4075222,5046038
8560,"Rien ne va plus",1997,245359,4800000,5045359
8561,"Night Peacook",2016,0,5045207,5045207
8562,"Tôkyô gûru",2017,0,5039008,5039008
8563,"Welcome to the Dollhouse",1996,4198137,836657,5034794
8564,"Hands of Stone",2016,4712792,319183,5031975
8565,"Hei Bai Mi Gong",2017,0,5029820,5029820
8566,"Monty Python and the Holy Grail",1975,3427696,1601252,5028948
8567,"Stop Making Sense",1984,5020659,6820,5027479
8568,"Xuan Zang",2016,0,5023106,5023106
8569,"Airheads",1994,5021868,0,5021868
8570,"American Dreamer",1984,5021751,0,5021751
8571,"Nikita",1991,5017971,0,5017971
8572,"Incident in a Ghostland",2018,0,5016680,5016680
8573,"Savva. Serdtse voyna",2015,0,5015080,5015080
8574,"Seven Brides for Seven Brothers",1954,5000000,13550,5013550
8575,"Radio Dayz",2008,0,5007804,5007804
8576,"Kuru",2018,0,5007430,5007430
8577,"Hibana",2017,0,5005352,5005352
8578,"Tempest",1982,5005245,0,5005245
8579,"Bubble Boy",2001,5002310,0,5002310
8580,"Munna Michael",2017,64949,4937340,5002289
8581,"Flawless",2008,1200234,3800000,5000234
8582,"Destination Moon",1950,5000000,0,5000000
8583,"Darling Lili",1970,5000000,0,5000000
8584,"Pocketful of Miracles",1961,5000000,0,5000000
8585,"The Exterminator",1980,5000000,0,5000000
8586,"The Boys Next Door",1986,5000000,0,5000000
8587,"There's No Business Like Show Business",1954,5000000,0,5000000
8588,"Hard Times",1975,5000000,0,5000000
8589,"The Beast from 20,000 Fathoms",1953,5000000,0,5000000
8590,"Death Hunt",1981,5000000,0,5000000
8591,"Hero and the Terror",1988,5000000,0,5000000
8592,"Monkey Shines",1988,5000000,0,5000000
8593,"Call Me Mister",1951,5000000,0,5000000
8594,"Elvira, Mistress of the Dark",1988,5000000,0,5000000
8595,"Paradise",1982,5000000,0,5000000
8596,"Second Sight",1989,5000000,0,5000000
8597,"The Ballad of Cable Hogue",1970,3500000,1500000,5000000
8598,"Krabat",2008,0,5000000,5000000
8599,"Kochira Katsushika-ku Kamearikoenmae Hashutsujo…",2011,0,4999718,4999718
8600,"The Lover",1992,4899194,100198,4999392
8601,"Hai supîdo!: Free! Starting Days",2015,0,4997409,4997409
8602,"No Small Affair",1984,4994094,0,4994094
8603,"MR 73",2008,0,4993520,4993520
8604,"Top Dog",1995,4992085,0,4992085
8605,"Jiang shan mei ren",2008,0,4991819,4991819
8606,"Invaders from Mars",1986,4884663,100000,4984663
8607,"Fanny och Alexander",1983,4971340,12460,4983800
8608,"Shan he gu ren",2015,82913,4894351,4977264
8609,"Hideous Kinky",1999,1368627,3607472,4976099
8610,"Dolor y gloria",2019,0,4973201,4973201
8611,"Cyprien",2009,0,4972396,4972396
8612,"Take Shelter",2011,1728953,3243063,4972016
8613,"Let it Ride",1989,4971088,0,4971088
8614,"The Mafia, The Salesman",2007,0,4970196,4970196
8615,"Aus dem Nichts",2017,321011,4648110,4969121
8616,"Keurosing",2008,0,4968755,4968755
8617,"L'avenir",2016,388265,4580413,4968678
8618,"Gloria",1999,4167493,800000,4967493
8619,"Bao Xue Jiang Zhi",2017,0,4964366,4964366
8620,"The Handmaid's Tale",1990,4960385,0,4960385
8621,"Carancho",2011,85526,4873834,4959360
8622,"Bing Feng Xia 2",2018,0,4957041,4957041
8623,"Jakob the Liar",1999,4956401,0,4956401
8624,"Thoda Pyaar Thoda Magic",2008,335874,4615005,4950879
8625,"Victoria",2016,0,4948511,4948511
8626,"Quackerz",2016,0,4946941,4946941
8627,"Officer of the Year",2011,0,4946097,4946097
8628,"Desierto",2016,2002036,2938383,4940419
8629,"Before I Wake",2016,0,4937677,4937677
8630,"Robot & Frank",2012,3317468,1616888,4934356
8631,"Hamlet 2",2008,4886216,47888,4934104
8632,"Solo",1996,4932915,0,4932915
8633,"Jeonguk Norae Jarang",2013,0,4930704,4930704
8634,"One Foundation",2007,0,4927651,4927651
8635,"From Justin to Kelly",2003,4922166,0,4922166
8636,"Im Labyrinth des Schweigens",2014,794452,4122863,4917315
8637,"Gukgadaepyo 2",2016,0,4916489,4916489
8638,"Surf Ninjas",1993,4916135,0,4916135
8639,"Breathe",2017,489322,4425037,4914359
8640,"Babo",2008,0,4913889,4913889
8641,"Heaven's Prisoners",1996,4912939,0,4912939
8642,"Half Nelson",2006,2697938,2213787,4911725
8643,"Enron: The Smartest Guys in the Room",2005,4071700,836079,4907779
8644,"A Song to the Sun",2006,0,4907665,4907665
8645,"The Playboys",1992,4906900,0,4906900
8646,"Aaja Nachle",2007,484108,4421482,4905590
8647,"Giniro No Season",2008,0,4904830,4904830
8648,"Harry & Son",1984,4900000,0,4900000
8649,"The Anniversary Party",2001,4013506,884559,4898065
8650,"Ying Xiong Ben Se",2017,0,4898009,4898009
8651,"Insaengeun Areumdawo",2011,0,4894718,4894718
8652,"Go Fast",2008,0,4893014,4893014
8653,"Rainbow Brite and the Star Stealer",1985,4889971,0,4889971
8654,"L'amant double",2017,167093,4721337,4888430
8655,"The Seduction",1982,4888270,0,4888270
8656,"Gekijô-ban Kamen Raidâ Birudo: Bî Za Wan",2018,0,4888000,4888000
8657,"Return to the Wolves",2017,0,4886088,4886088
8658,"High School Musical: El Desafio",2008,0,4884392,4884392
8659,"Eiga: Tôken ranbu",2019,0,4882411,4882411
8660,"Ittefaq",2017,298032,4583473,4881505
8661,"Pretty Cure!: Kiseki no Henshin! Cure Mofurun!",2016,0,4881491,4881491
8662,"Girl 6",1996,4880941,0,4880941
8663,"The Assassination of Richard Nixon",2004,708776,4171367,4880143
8664,"Se son rose",2018,0,4878325,4878325
8665,"Cherry Returns",2016,0,4878197,4878197
8666,"Innocent Blood",1992,4877567,0,4877567
8667,"Avan Ivan",2011,0,4876819,4876819
8668,"Uri: The Surgical Strike",2019,4185663,691137,4876800
8669,"He Knows You're Alone",1980,4875436,0,4875436
8670,"Hilary and Jackie",1998,4874838,0,4874838
8671,"Abzurdah",2015,0,4874541,4874541
8672,"Genghis Khan: To the Ends of the Earth and Sea",2008,3892,4870606,4874498
8673,"Bon Bini Holland",2015,0,4873460,4873460
8674,"T-Guardians",2017,0,4870845,4870845
8675,"Torch Song Trilogy",1988,4865997,0,4865997
8676,"Band of the Hand",1986,4865912,0,4865912
8677,"Galaxina",1980,4865000,0,4865000
8678,"Take This Waltz",2012,1239692,3623640,4863332
8679,"Blindspotting",2018,4333394,529667,4863061
8680,"Rize",2005,3278611,1579120,4857731
8681,"Guten Tag, Ramon",2015,154356,4700000,4854356
8682,"Samson",2018,4719928,127223,4847151
8683,"Rustlers' Rhapsody",1985,4847085,0,4847085
8684,"Balkanskiy rubezh",2019,0,4845665,4845665
8685,"The Corporation",2004,3493516,1350056,4843572
8686,"Ahwak",2015,0,4843164,4843164
8687,"La Croisière",2011,0,4842801,4842801
8688,"Off Beat",1986,4842778,0,4842778
8689,"The Sense of an Ending",2017,1274420,3568197,4842617
8690,"Ma Loute",2016,112481,4727894,4840375
8691,"D.P.A. Detetives Do Prédio Azul - O Filme",2017,0,4836164,4836164
8692,"The Angels’ Share",2013,312339,4523246,4835585
8693,"Sous le même toit",2017,0,4820659,4820659
8694,"Nelyubov",2017,564073,4255436,4819509
8695,"Ostwind - Aris Ankunft",2019,0,4818297,4818297
8696,"90 Minutes in Heaven",2015,4816142,0,4816142
8697,"Bottle Shock",2008,4078607,737283,4815890
8698,"Jia HeWan Shi Jing",2019,0,4815816,4815816
8699,"Angus",1995,4812891,0,4812891
8700,"One Missed Call Final",2006,0,4810002,4810002
8701,"Hedefim Sensin",2018,0,4808639,4808639
8702,"The Girl with all the Gifts",2016,0,4801837,4801837
8703,"The Hunger",1983,4800000,0,4800000
8704,"King David",1985,4800000,0,4800000
8705,"The Honorary Consul",1983,4800000,0,4800000
8706,"The Lonely Guy",1984,4800000,0,4800000
8707,"KEDi",2017,2834262,1963522,4797784
8708,"Tere Naal Love Ho Gaya",2012,177743,4619876,4797619
8709,"Jack the Bear",1993,4796751,0,4796751
8710,"See You in the Morning",1989,4795009,0,4795009
8711,"Roman de Gare",2008,1852764,2941851,4794615
8712,"Lyubovnitsy",2019,0,4793748,4793748
8713,"Aap Kaa Surroor",2007,0,4791144,4791144
8714,"Into the West",1993,4790801,0,4790801
8715,"Quand J'Etais Chanteur",2006,0,4785410,4785410
8716,"Qi Pa Duo Duo",2018,0,4778869,4778869
8717,"Igby Goes Down",2002,4777465,0,4777465
8718,"El Ciudadano Ilustre",2016,0,4774723,4774723
8719,"Ushijima the Loan Shark Part 3",2016,0,4773629,4773629
8720,"Bee Season",2005,1180560,3592748,4773308
8721,"La Ragazza Nella Nebbia",2017,0,4769802,4769802
8722,"Masa ile Koca Ayi",2015,0,4764908,4764908
8723,"Mansfield Park",1999,4764741,0,4764741
8724,"The Good Mother",1988,4764606,0,4764606
8725,"Force",2011,0,4763946,4763946
8726,"Upin & Ipin: Keris Siamang Tunggal",2018,0,4759000,4759000
8727,"La Leyenda del Chupacabras",2016,0,4758094,4758094
8728,"Gulyay, Vasya!",2017,0,4756578,4756578
8729,"Talk to Me",2007,4526759,229146,4755905
8730,"Delirious",1991,4755853,0,4755853
8731,"The Warriors",2016,0,4754904,4754904
8732,"Atlas Shrugged: Part 1",2011,4752353,0,4752353
8733,"Oggi Sposi",2009,0,4752036,4752036
8734,"The Fall of the Roman Empire",1964,4750000,0,4750000
8735,"Tea Pets",2017,0,4746669,4746669
8736,"Violets Are Blue...",1986,4743287,0,4743287
8737,"Grandview, U.S.A.",1984,4743119,0,4743119
8738,"La finale",2018,0,4742293,4742293
8739,"A Walk on the Moon",1999,4741987,0,4741987
8740,"Le Jeune Karl Marx",2017,125659,4615086,4740745
8741,"Fune Wo Amu",2013,0,4739387,4739387
8742,"This is Spinal Tap",1984,4736202,0,4736202
8743,"An",2015,124800,4610530,4735330
8744,"Confetti",2006,228498,4506731,4735229
8745,"Northmen — A Viking Saga",2015,0,4732232,4732232
8746,"Food, Inc.",2009,4417674,314270,4731944
8747,"Ghost in the Machine",1993,4731273,0,4731273
8748,"Peppa Pig: The Golden Boots",2015,0,4729608,4729608
8749,"Drugstore Cowboy",1989,4729352,0,4729352
8750,"Tao Jie",2013,0,4728896,4728896
8751,"My Summer of Love",2005,1000915,3726460,4727375
8752,"New York",2009,997437,3729842,4727279
8753,"The Other Side of Heaven",2001,4720371,0,4720371
8754,"Kamen Rider 1 Go",2016,0,4717643,4717643
8755,"Your Friends and Neighbors",1998,4714658,0,4714658
8756,"Held Up",2000,4714090,0,4714090
8757,"Miss March",2009,4543320,169739,4713059
8758,"King Naresuan 3",2010,0,4712115,4712115
8759,"King Kong Lives",1986,4711220,0,4711220
8760,"Snezhnaya koroleva. Zazerkale",2018,0,4709032,4709032
8761,"Jeff, Who Lives at Home",2012,4269426,438701,4708127
8762,"Monsutâ sutoraiku the Movie: Hajimari no basho",2016,0,4706057,4706057
8763,"Le père Noël",2014,0,4705457,4705457
8764,"Eve of Destruction",1991,4704884,0,4704884
8765,"Lope",2010,0,4704421,4704421
8766,"Whitney",2018,3026558,1677151,4703709
8767,"Aurore",2017,0,4700666,4700666
8768,"C.H.U.D.",1984,4700000,0,4700000
8769,"Terkel i knibe",2010,161507,4535210,4696717
8770,"Hana ikusa",2017,0,4696006,4696006
8771,"Miller's Crossing",1990,4693759,0,4693759
8772,"True Identity",1991,4693236,0,4693236
8773,"On the Line",2001,4365455,325347,4690802
8774,"Apocalypse Now Redux",2001,4615959,73049,4689008
8775,"National Lampoon's Senior Trip",1995,4686937,0,4686937
8776,"Eddie and the Cruisers",1983,4685097,0,4685097
8777,"Prince",2010,144826,4539840,4684666
8778,"Get Santa",2014,0,4683142,4683142
8779,"What a Wonderful Family!",2017,0,4681992,4681992
8780,"Den Vyborov 2",2016,0,4680617,4680617
8781,"Avenging Force",1986,4679650,0,4679650
8782,"Pi",1998,3221152,1457361,4678513
8783,"My Chauffeur",1986,4676892,0,4676892
8784,"Rogue",2008,10452,4662925,4673377
8785,"Jin Gui Zi",2018,0,4668484,4668484
8786,"Demonic",2015,0,4668109,4668109
8787,"Gilda, no me arrepiento de este amor",2016,0,4663379,4663379
8788,"Evil Under the Sun",1982,4659287,0,4659287
8789,"Killer Joe",2012,1291645,3367465,4659110
8790,"The Hitman",1991,4654288,0,4654288
8791,"Radio Flyer",1992,4651977,0,4651977
8792,"When We Were Kings",1996,2666118,1981488,4647606
8793,"Ek Thi Daayan",2013,0,4647371,4647371
8794,"Japanese Story",2003,647054,4000000,4647054
8795,"Die Teufelskicker",2009,0,4643185,4643185
8796,"Dogman",2018,20506,4619270,4639776
8797,"Papa: Hemingway in Cuba",2016,1115615,3523922,4639537
8798,"Ploey: You Never Fly Alone",2018,0,4638488,4638488
8799,"7 Uczuc",2018,0,4636694,4636694
8800,"Two Faces of My Girlfriend",2007,0,4634831,4634831
8801,"Don't Come Knocking",2006,440793,4192564,4633357
8802,"Brotherhood",2016,0,4632334,4632334
8803,"Let's Go to Prison",2006,4630045,0,4630045
8804,"Mon bébé",2019,0,4623632,4623632
8805,"Buddy Cops",2016,0,4622802,4622802
8806,"No Mercy for the Rude",2006,0,4620791,4620791
8807,"Table 19",2017,3614896,1005503,4620399
8808,"Joe's Apartment",1996,4616355,0,4616355
8809,"Kido Senshi Gandamu NT (Naratibu)",2018,0,4615833,4615833
8810,"Crossing Over",2009,4462332,152012,4614344
8811,"Lovely and Amazing",2002,4210379,403103,4613482
8812,"January Man",1989,4611062,0,4611062
8813,"Longtime Companion",1990,4609953,0,4609953
8814,"Welcome to Collinwood",2002,378650,4227634,4606284
8815,"Where to Invade Next",2016,3827261,777426,4604687
8816,"Don Gato, el inicio de la pandilla",2015,0,4604656,4604656
8817,"Chung fung che",2015,0,4604136,4604136
8818,"Les Boys",1997,4602341,0,4602341
8819,"Eliminators",1986,4601256,0,4601256
8820,"Die Vampirschwestern 2",2014,0,4600126,4600126
8821,"River's Edge",1987,4600000,0,4600000
8822,"Anchors Aweigh",1945,4600000,0,4600000
8823,"Sunset",1988,4595000,0,4595000
8824,"Enemy",2014,1005824,3585010,4590834
8825,"Wang Pai",2014,0,4590000,4590000
8826,"Busco Novio Para Mi Mujer",2016,1741889,2843504,4585393
8827,"Submarine",2011,467602,4114335,4581937
8828,"12",2009,125120,4456241,4581361
8829,"Safari",2009,0,4580625,4580625
8830,"Girl in Progress",2012,2609412,1971122,4580534
8831,"Los Girasoles Ciegos",2008,0,4579058,4579058
8832,"Fire with Fire",1986,4577139,0,4577139
8833,"Conspirators",2013,0,4574135,4574135
8834,"Stealing Beauty",1996,4573330,0,4573330
8835,"Creator",1985,4571788,0,4571788
8836,"Please Give",2010,4033574,536604,4570178
8837,"The Company Men",2011,4444612,125355,4569967
8838,"Flying By",2009,0,4568257,4568257
8839,"No One Killed Jessica",2011,442036,4124767,4566803
8840,"Max Steel",2016,3818664,744416,4563080
8841,"Natale a Londra - Dio salvi la Regina",2016,0,4562806,4562806
8842,"Graffiti Bridge",1990,4562778,0,4562778
8843,"Ma tu di che segno 6?",2014,0,4562701,4562701
8844,"Laurel Canyon",2003,3663356,897794,4561150
8845,"Making the Grade",1984,4561000,0,4561000
8846,"Intermission",2004,889857,3671117,4560974
8847,"Mumford",1999,4559569,0,4559569
8848,"Lilja 4-ever",2003,181655,4375327,4556982
8849,"Tortilla Soup",2001,4447014,107147,4554161
8850,"Dangerous Beauty",1998,4553271,0,4553271
8851,"My Father",2007,0,4545849,4545849
8852,"People: Jet Set 2",2004,0,4545743,4545743
8853,"Jusqu'ici tout va bien",2019,0,4542862,4542862
8854,"Troll",1986,4542346,0,4542346
8855,"Boku no Kanojo wa Maho Tsukai",2019,0,4540085,4540085
8856,"Hope and Glory",1987,4537186,0,4537186
8857,"The Blinky Bill Movie",2015,0,4534854,4534854
8858,"Okuotoko",2018,0,4533658,4533658
8859,"Neol Gi-da-ri-myeo",2016,0,4532668,4532668
8860,"Les Municipaux, ces héros",2018,0,4531635,4531635
8861,"Oro",2017,5539,4522646,4528185
8862,"Buck",2011,4036175,487797,4523972
8863,"The Festival",2018,0,4523842,4523842
8864,"Pat a Mat: Zimní radovánky",2018,0,4519452,4519452
8865,"Italiano medio",2015,0,4518908,4518908
8866,"Nieve Negra",2017,0,4517796,4517796
8867,"Kimi no Manazashi",2017,0,4517524,4517524
8868,"Ladies vs Ricky Bahl",2011,0,4513021,4513021
8869,"Grizzly Man",2005,3178403,1326048,4504451
8870,"Flash of Genius",2008,4442377,61734,4504111
8871,"Gekijouban Mazinger Z",2017,0,4502612,4502612
8872,"Kickin It Old Skool",2007,4500147,0,4500147
8873,"Road to Rio",1947,4500000,0,4500000
8874,"Bus Stop",1956,4500000,0,4500000
8875,"Winchester '73",1950,4500000,0,4500000
8876,"Suspicion",1941,4500000,0,4500000
8877,"The Great Caruso",1951,4500000,0,4500000
8878,"Night Crossing",1982,4500000,0,4500000
8879,"An American in Paris",1951,4500000,0,4500000
8880,"SMS - Sotto mentite spoglie",2007,0,4498707,4498707
8881,"Bound by Honor",1993,4496583,0,4496583
8882,"Diggstown",1992,4495615,0,4495615
8883,"Mees Kees op de planken",2014,0,4495549,4495549
8884,"Coast to Coast",1980,4495445,0,4495445
8885,"The Wall",2017,1803064,2692198,4495262
8886,"Only God Forgives",2013,775849,3718711,4494560
8887,"Die Goldfische",2019,0,4491178,4491178
8888,"Un'Estate Ai Caraibi",2009,0,4487215,4487215
8889,"Flawless",1999,4485485,0,4485485
8890,"Spread",2009,250617,4234319,4484936
8891,"Fen shou zai shuo wo ai ni",2015,0,4480590,4480590
8892,"Dilili à Paris",2018,0,4477741,4477741
8893,"The Haunted House: The Secret of the Cave",2018,0,4471732,4471732
8894,"Abbaneun Ddal",2017,0,4469282,4469282
8895,"Dong-chang-saeng",2013,0,4467956,4467956
8896,"Sore Ike! Anpanman: Kagayake! Kurun to Inochi n…",2018,0,4467225,4467225
8897,"Colossal",2017,3194575,1270826,4465401
8898,"Loose Cannons",1990,4463085,0,4463085
8899,"Joy of Sex",1984,4463000,0,4463000
8900,"Photo de famille",2018,0,4462678,4462678
8901,"Lantana",2001,4460426,0,4460426
8902,"Reality",2012,83736,4371123,4454859
8903,"Geograf globus propil",2013,0,4454853,4454853
8904,"Passchendaele",2008,4452423,904,4453327
8905,"Smeshariki. Dezha vyu",2018,0,4451947,4451947
8906,"Belli di papa'",2015,0,4450839,4450839
8907,"Ying Jiu Fei Hu Dui",2017,0,4447734,4447734
8908,"Italian for Beginners",2002,4447186,0,4447186
8909,"Enes Batur Hayal mi Gerçek mi?",2018,0,4445715,4445715
8910,"Walk on Water",2005,2712736,1730333,4443069
8911,"Eiga Yokai Wotchi Tanjo no Himitsu da Nyan!",2015,0,4437777,4437777
8912,"The Last Word",2017,1779620,2657526,4437146
8913,"Ikimizin Yerine",2016,0,4434937,4434937
8914,"Bad Samaritan",2018,3424744,1009979,4434723
8915,"Song of the Sea",2014,857524,3576850,4434374
8916,"Fist & Faith",2017,0,4433919,4433919
8917,"Love Story 2050",2008,0,4432928,4432928
8918,"D.P.A. Detetives Do Prédio Azul 2 - O Filme",2018,0,4432618,4432618
8919,"Mamma o Papa?",2017,0,4431189,4431189
8920,"Bu Bu Jing Xin",2015,0,4430000,4430000
8921,"Black Beauty",1994,4428830,0,4428830
8922,"Playing God",1997,4166918,261609,4428527
8923,"Bei Jing Shi Jian",2015,0,4428450,4428450
8924,"Sanyang",2016,0,4422347,4422347
8925,"Safety Not Guaranteed",2012,4010957,411361,4422318
8926,"The Conversation",1974,4420000,0,4420000
8927,"Don’t Think Twice",2016,4417983,0,4417983
8928,"Keeping Up with the Steins",2006,4339241,75512,4414753
8929,"Capturing the Friedmans",2003,3117985,1291449,4409434
8930,"Run",1991,4409328,0,4409328
8931,"Tabaluga",2018,0,4409314,4409314
8932,"Inchon",1982,4408636,0,4408636
8933,"Les Aristos",2006,0,4408441,4408441
8934,"McHale's Navy",1997,4408420,0,4408420
8935,"The Tao of Steve",2000,4342203,63827,4406030
8936,"Nôgêmu nôraifu: Zero",2017,0,4401961,4401961
8937,"Bienvenue à Marly-Gomont",2016,0,4401654,4401654
8938,"For Me and My Gal",1942,4400000,0,4400000
8939,"Thrill of a Romance",1945,4400000,0,4400000
8940,"The Bravados",1958,4400000,0,4400000
8941,"A Star is Born",1954,4400000,0,4400000
8942,"Willie and Phil",1980,4400000,0,4400000
8943,"Simply Irresistible",1999,4398989,0,4398989
8944,"Hello",2017,0,4394131,4394131
8945,"The Company of Wolves",1985,4389334,0,4389334
8946,"Forced Vengeance",1982,4388500,0,4388500
8947,"Mental",2012,17669,4368290,4385959
8948,"Pumpkinhead",1988,4385516,0,4385516
8949,"Synecdoche, New York",2008,3083538,1300000,4383538
8950,"The Book of Henry",2017,4288104,91801,4379905
8951,"’71",2015,1270847,3106411,4377258
8952,"SuperBobrovy",2016,0,4376775,4376775
8953,"Dark Angel",1990,4372561,0,4372561
8954,"Fever Pitch",1999,113384,4257705,4371089
8955,"Kabali",2016,3903095,466521,4369616
8956,"Seven Days In Utopia",2011,4367448,0,4367448
8957,"Vettai",2012,202581,4163695,4366276
8958,"Batman: The Killing Joke",2016,3775000,586038,4361038
8959,"Solitary Man",2010,4360548,0,4360548
8960,"Wagons East",1994,4358940,0,4358940
8961,"Xin Ling De Yang Guang",2010,0,4358853,4358853
8962,"The Broadway Melody",1929,2800000,1558000,4358000
8963,"Spartan",2004,4357745,0,4357745
8964,"Bogus",1996,4357406,0,4357406
8965,"Meet the Deedles",1998,4356126,0,4356126
8966,"Tu Hao Qing Ren Jie",2015,0,4350000,4350000
8967,"The Mean Season",1985,4349446,0,4349446
8968,"Nijiiro Days",2018,0,4349271,4349271
8969,"Staying Together",1989,4348025,0,4348025
8970,"Sayonara no asa ni yakusoku no hana o kazarô",2018,0,4343981,4343981
8971,"Sleeping Dogs Lie",2006,15745,4326414,4342159
8972,"General Rouge no Gaisen",2009,0,4341479,4341479
8973,"Entre Amis",2015,0,4335699,4335699
8974,"He Named Me Malala",2015,2668936,1665280,4334216
8975,"PCU",1994,4333569,0,4333569
8976,"Green Street Hooligans",2005,345821,3987450,4333271
8977,"Sensei!",2017,0,4333105,4333105
8978,"Selfie",2017,0,4330232,4330232
8979,"National Theatre Live: The Audience",2013,0,4330068,4330068
8980,"Much Ado About Nothing",2013,4328850,0,4328850
8981,"Manatsu no Orion",2009,0,4323830,4323830
8982,"Dhol",2007,0,4318679,4318679
8983,"Flash Point",2008,3271,4314771,4318042
8984,"Welcome",2010,13461,4303513,4316974
8985,"Lucky Break",2002,54606,4261891,4316497
8986,"Wild Card",2015,3200,4312589,4315789
8987,"Velvet Goldmine",1998,1053788,3259856,4313644
8988,"Melvin and Howard",1980,4309490,0,4309490
8989,"Tsukigami",2007,0,4306083,4306083
8990,"Trenchcoat",1983,4304286,0,4304286
8991,"Disco Polo",2015,0,4301648,4301648
8992,"Four Rooms",1995,4301000,0,4301000
8993,"Bob Roberts",1992,4300703,0,4300703
8994,"All the Marbles",1981,4300000,0,4300000
8995,"G.I. Blues",1960,4300000,0,4300000
8996,"Yellowbeard",1983,4300000,0,4300000
8997,"Thief",1981,4300000,0,4300000
8998,"Marooned",1969,4300000,0,4300000
8999,"Per qualche dollaro in più",1967,4300000,0,4300000
9000,"Place Publique",2018,0,4299975,4299975
9001,"Eden Lake",2008,7321,4287052,4294373
9002,"Flipped",2010,1755212,2534781,4289993
9003,"Evelyn",2002,1483975,2805534,4289509
9004,"Keunalui bonwigi",2016,0,4289474,4289474
9005,"Soul Survivors",2001,3100650,1187596,4288246
9006,"Hasta que la boda nos separe",2018,0,4283757,4283757
9007,"Romeo and Juliet (Secret Cinema 2018)",2018,0,4282983,4282983
9008,"Tomboy",2011,130271,4152278,4282549
9009,"Best Seller",1987,4278150,0,4278150
9010,"Aadu 2",2017,0,4273904,4273904
9011,"Glitter",2001,4273372,0,4273372
9012,"Dutch",1991,4271022,0,4271022
9013,"Heidi's Song",1982,4269402,0,4269402
9014,"Van Wilder Deux: The Rise of Taj",2006,4261350,0,4261350
9015,"Jia zhuang qing lu",2011,0,4259100,4259100
9016,"Goal! 2: Living the Dream...",2008,225067,4034000,4259067
9017,"Demolition",2016,1978592,2274705,4253297
9018,"Therese Desqueyroux",2012,226555,4026508,4253063
9019,"Hot Dog",2018,0,4251298,4251298
9020,"Rosalie Blum",2016,0,4251230,4251230
9021,"Lambada",1990,4248622,0,4248622
9022,"Mr. Nanny",1993,4247162,0,4247162
9023,"Brick",2006,2075743,2168253,4243996
9024,"Tô Ryca!",2016,0,4243953,4243953
9025,"Il Vegetale",2018,0,4241706,4241706
9026,"Najlepszy",2017,0,4241533,4241533
9027,"Men with Brooms",2002,4239767,0,4239767
9028,"The Gospel of John",2003,4068087,166268,4234355
9029,"Juliet, Naked",2018,3444895,788023,4232918
9030,"Holy Motors",2012,641054,3589372,4230426
9031,"Roadie",1980,4226370,0,4226370
9032,"Gaston Lagaffe",2018,0,4224925,4224925
9033,"Amis Publics N°1",2016,0,4222361,4222361
9034,"Left Behind",2001,4221341,0,4221341
9035,"Liliane Susewind - Ein tierisches Abenteuer",2018,0,4220933,4220933
9036,"Pinku to gurê",2016,0,4215944,4215944
9037,"Go! Princess Pretty Cure The Movie Go! Go!! Gor…",2015,0,4214364,4214364
9038,"Saya-zamurai",2011,0,4213126,4213126
9039,"That's Dancing",1985,4210938,0,4210938
9040,"Welcome to the Punch",2013,7034,4200068,4207102
9041,"Beastie Boys",2008,0,4205499,4205499
9042,"Kursk",2018,0,4205410,4205410
9043,"Storm Boy",2019,69566,4133394,4202960
9044,"The Damned United",2009,449865,3750009,4199874
9045,"Richard III",1995,2684904,1514430,4199334
9046,"ESPN's Ultimate X - The Movie",2002,4197175,0,4197175
9047,"Sweet and Lowdown",1999,4196621,0,4196621
9048,"The Tango Lesson",1997,1026402,3167636,4194038
9049,"Tanu Weds Manu Returns",2015,3043479,1149465,4192944
9050,"Red Scorpion",1989,4192000,0,4192000
9051,"The Long Way Home",2015,0,4185530,4185530
9052,"Twin Peaks: Fire Walk With Me",1992,4160851,23968,4184819
9053,"Les femmes de l'ombre",2008,0,4183710,4183710
9054,"Zan'e: Sunde wa ikenai heya",2016,0,4182808,4182808
9055,"Nitro Circus: The Movie 3D",2012,3377000,805062,4182062
9056,"Listen to Me",1989,4177448,0,4177448
9057,"With a Friend Like Harry",2000,4174495,0,4174495
9058,"Pak Van Mijn Hart",2014,0,4170873,4170873
9059,"Den Skyldige",2018,207140,3960535,4167675
9060,"Un homme idéal",2015,0,4167356,4167356
9061,"Les Gardiennes",2017,177331,3989872,4167203
9062,"In guerra per amore",2016,0,4166265,4166265
9063,"Priest",1995,4165845,0,4165845
9064,"Dil Dhadakne Do",2015,3066100,1098363,4164463
9065,"The Cobbler",2015,0,4161533,4161533
9066,"Bride Flight",2011,501360,3659927,4161287
9067,"Mostly Martha (Drei Sterne)",2002,4160475,0,4160475
9068,"Girl",2018,0,4157987,4157987
9069,"La tete haute",2015,26144,4131123,4157267
9070,"Good Hair",2009,4157223,0,4157223
9071,"Cuban Fury",2014,57105,4100000,4157105
9072,"Noi e la Giulia",2015,0,4156499,4156499
9073,"Waiting for a Miracle",2007,0,4152160,4152160
9074,"Witless Protection",2008,4151836,0,4151836
9075,"Good Time",2017,2026498,2117630,4144128
9076,"Jimmy's Hall",2014,560341,3582912,4143253
9077,"Whipped",2000,4142507,0,4142507
9078,"360",2012,100343,4040908,4141251
9079,"Smeshariki. Legenda o Zolotom Drakone",2016,0,4140403,4140403
9080,"Pawn Sacrifice",2015,2436308,1702439,4138747
9081,"Ghost Stories",2018,135095,4003081,4138176
9082,"To Gillian on Her 37th Birthday",1996,4137645,0,4137645
9083,"Heart Condition",1990,4134992,0,4134992
9084,"Iftarlik Gazoz",2016,0,4134490,4134490
9085,"From Prada to Nada",2011,3033623,1100069,4133692
9086,"Mistress America",2015,2500431,1632695,4133126
9087,"HHhH",2017,0,4132063,4132063
9088,"A Quiet Passion",2016,1865396,2266123,4131519
9089,"Comme les autres",2008,0,4130967,4130967
9090,"Dino King",2018,0,4129689,4129689
9091,"The To Do List",2013,3491669,637159,4128828
9092,"Emergo",2012,256,4126361,4126617
9093,"Choke",2008,2926565,1197712,4124277
9094,"Nativity Rocks!",2018,0,4121839,4121839
9095,"Cliente",2008,0,4121833,4121833
9096,"Qi Xiao Luo Han",2010,0,4120000,4120000
9097,"Po cem muži touží",2018,0,4119470,4119470
9098,"Venom",1982,4117958,0,4117958
9099,"Stay",2005,3626883,491000,4117883
9100,"Joker",2012,169181,3947336,4116517
9101,"Pichi Garu",2017,0,4116303,4116303
9102,"The Hero",2017,4077333,35036,4112369
9103,"L'empreinte de l'ange",2008,0,4112292,4112292
9104,"Çakallarla Dans 4",2016,0,4111121,4111121
9105,"Partners",1982,4109724,0,4109724
9106,"Kama Sutra",1997,4109095,0,4109095
9107,"This Boy's Life",1993,4104962,0,4104962
9108,"Changing Times",2006,545255,3558905,4104160
9109,"Kissing a Fool",1998,4100505,0,4100505
9110,"My Science Project",1985,4100000,0,4100000
9111,"Easy to Wed",1946,4100000,0,4100000
9112,"Restoration",1995,4100000,0,4100000
9113,"The Harvey Girls",1946,4100000,0,4100000
9114,"Beata ignoranza",2017,0,4097355,4097355
9115,"Until September",1984,4097094,0,4097094
9116,"Werk ohne Autor",2018,1206117,2887688,4093805
9117,"Aibô shirîzu Kanshiki Yonezawa Mamoru no jikenbo",2009,0,4089965,4089965
9118,"¡Átame!",1990,4087000,0,4087000
9119,"8 luchshikh svidaniy",2016,0,4085444,4085444
9120,"Flood",2007,0,4084232,4084232
9121,"The Beach Bum",2019,3415998,664618,4080616
9122,"That's Life!",1986,4079895,0,4079895
9123,"Impromptu",1991,4076211,0,4076211
9124,"Caprice",1967,4075000,0,4075000
9125,"Meet Wally Sparks",1997,4073582,0,4073582
9126,"Bankier Van Het Verzet",2018,0,4068853,4068853
9127,"Belle de Jour",1968,4056534,12027,4068561
9128,"Katti Batti",2015,364932,3703078,4068010
9129,"Lisa",1990,4067725,0,4067725
9130,"Pari",2018,0,4065233,4065233
9131,"Le Diner de Cons",1999,4065116,0,4065116
9132,"Stone",2010,1810078,2254942,4065020
9133,"Tank Girl",1995,4064333,0,4064333
9134,"Bajo el mismo techo",2019,0,4063839,4063839
9135,"Peter’s Friends",1992,4058564,0,4058564
9136,"The Winslow Boy",1999,4058350,0,4058350
9137,"Ju-on: Za fainaru",2015,0,4054991,4054991
9138,"Mademoiselle de Joncquières",2018,0,4054477,4054477
9139,"Yi wan nian yi hou",2015,0,4050000,4050000
9140,"King's Ransom",2005,4008527,41000,4049527
9141,"Antonia",1996,4047426,0,4047426
9142,"Werner - Eiskalt",2011,0,4046409,4046409
9143,"Mediterraneo",1992,4044228,0,4044228
9144,"Trois couleurs: Rouge",1994,4043000,0,4043000
9145,"Breaking the Waves",1996,4040691,0,4040691
9146,"Yapisik Kardesler",2015,0,4035238,4035238
9147,"Schultze Gets the Blues",2005,595071,3439161,4034232
9148,"The Mustang",2019,4032770,0,4032770
9149,"Passed Away",1992,4030793,0,4030793
9150,"Selbst",2018,0,4028984,4028984
9151,"Bolshoy",2017,0,4026003,4026003
9152,"Taras Bulba",1962,4000000,24833,4024833
9153,"Idle Hands",1999,4023741,0,4023741
9154,"There Be Dragons",2011,1069334,2951656,4020990
9155,"Sketch",2018,0,4020070,4020070
9156,"Here Comes the Grump",2018,2150,4017345,4019495
9157,"Visages villages",2017,952432,3065087,4017519
9158,"Vallanzasca - Gli angeli del male",2010,0,4017500,4017500
9159,"The Three Little Pigs 2",2017,0,4015456,4015456
9160,"DiDi's Dreams",2017,0,4013033,4013033
9161,"Mrs. Soffel",1984,4012827,0,4012827
9162,"Mountains of the Moon",1990,4011793,0,4011793
9163,"A Perfect Day",2015,5002,4006302,4011304
9164,"Sanada Jûyûshi",2016,0,4010847,4010847
9165,"Short Time",1990,4010647,0,4010647
9166,"Eksi Elmalar",2016,0,4009596,4009596
9167,"I Feel Good",2018,0,4008571,4008571
9168,"8 Heads in a Duffel Bag",1997,3602884,400000,4002884
9169,"Marseille",2016,0,4000349,4000349
9170,"The Stepford Wives",1975,4000000,0,4000000
9171,"Dillinger",1945,4000000,0,4000000
9172,"Kagemusha",1980,4000000,0,4000000
9173,"You Can't Take It With You",1938,4000000,0,4000000
9174,"The Million Dollar Duck",1971,4000000,0,4000000
9175,"A Yank in the R.A.F.",1941,4000000,0,4000000
9176,"Tai-Pan",1986,4000000,0,4000000
9177,"The Boogens",1982,4000000,0,4000000
9178,"Willy Wonka & the Chocolate Factory",1971,4000000,0,4000000
9179,"The Beast Within",1982,4000000,0,4000000
9180,"Vamp",1986,4000000,0,4000000
9181,"Alexander's Ragtime Band",1938,4000000,0,4000000
9182,"Jailhouse Rock",1957,4000000,0,4000000
9183,"Blood Feast",1963,4000000,0,4000000
9184,"Leonard Part 6",1987,4000000,0,4000000
9185,"Brainscan",1994,4000000,0,4000000
9186,"Ingagi",1931,4000000,0,4000000
9187,"Die Laughing",1980,4000000,0,4000000
9188,"Star!",1968,4000000,0,4000000
9189,"Buck Privates",1941,4000000,0,4000000
9190,"Made in Heaven",1987,4000000,0,4000000
9191,"American Ninja 2: The Confrontation",1987,4000000,0,4000000
9192,"Amazing Grace and Chuck",1987,4000000,0,4000000
9193,"Les Malheurs de Sophie",2016,0,3998736,3998736
9194,"The Mighty Quinn",1989,3992420,0,3992420
9195,"Yildizlar da Kayar: Das Borak",2016,0,3990860,3990860
9196,"Ragnarok",2014,1369,3988881,3990250
9197,"Welcome Home, Roxy Carmichael",1990,3989297,0,3989297
9198,"Strana chudes",2016,0,3987780,3987780
9199,"The Broken Circle Breakdown",2012,175038,3810188,3985226
9200,"The Story of the Weeping Camel",2004,1751698,2230721,3982419
9201,"Nous trois ou rien",2015,0,3982029,3982029
9202,"Chopper",2000,234259,3746436,3980695
9203,"Goyangyi: Jookeumeul Boneun Doo Gaeui Noon",2011,0,3980234,3980234
9204,"Kochaj i Tancz",2009,0,3977016,3977016
9205,"Step Into Liquid",2003,3681803,293739,3975542
9206,"Geunal, bada",2018,0,3972816,3972816
9207,"Spider-Man/Men in Black II Double-Bill",2002,3971552,0,3971552
9208,"Wedding Daze",2008,0,3969756,3969756
9209,"2.0",2018,0,3967923,3967923
9210,"Bat*21",1988,3966256,0,3966256
9211,"Memories of Me",1988,3965000,0,3965000
9212,"Missing",2008,0,3964925,3964925
9213,"Soreike! Anpanman Mija To Maho No Lamp",2015,0,3963396,3963396
9214,"Die wilden Kerle 6 - Die Legende lebt",2016,0,3963295,3963295
9215,"Tonari no kaibutsu kun",2018,0,3962689,3962689
9216,"Metti la nonna in freezer",2018,0,3961770,3961770
9217,"Koisaika Miyamoto",2017,0,3960502,3960502
9218,"Tudo por um Pop Star",2018,0,3960475,3960475
9219,"Kimi no suizô wo tabetai",2018,0,3959923,3959923
9220,"Er Ci Chu Lian",2017,0,3957193,3957193
9221,"Tholi Prema",2018,0,3956883,3956883
9222,"Ed",1996,3956785,0,3956785
9223,"Playing by Heart",1998,3956212,0,3956212
9224,"Il Papa di Giovanna",2008,0,3955837,3955837
9225,"El guardián invisible",2017,0,3954408,3954408
9226,"The Phantom of the Opera",1989,3953745,0,3953745
9227,"Joysticks",1983,3952000,0,3952000
9228,"Qualquer Gato Vira-Lata",2011,0,3950978,3950978
9229,"Hello Carbot The Movie: The Secret of Omphalos …",2019,0,3947864,3947864
9230,"Ma Famille T’Adore Déjà",2016,0,3947091,3947091
9231,"Tschick",2016,0,3946873,3946873
9232,"Verliefd Op Cuba",2019,0,3943653,3943653
9233,"Gordy",1995,3941146,0,3941146
9234,"Yeol-jeong-gat-eun-so-ri-ha-go-it-ne",2015,0,3939736,3939736
9235,"The Pebble and the Penguin",1995,3939728,0,3939728
9236,"Sleight",2017,3930990,3460,3934450
9237,"Hagane no renkinjutsushi: Mirosu no seinaru hoshi",2012,178000,3756008,3934008
9238,"The Perfect Game",2010,1089445,2841922,3931367
9239,"Chiamatemi Francesco - Il papa della gente",2015,0,3925769,3925769
9240,"Eiga no Osomatsusan",2019,0,3925767,3925767
9241,"Gracie",2007,2956339,965704,3922043
9242,"The Nile Hilton Incident",2017,80953,3838160,3919113
9243,"Escobar: Paradise Lost",2015,195792,3721887,3917679
9244,"Mrs. Palfrey at the Claremont",2005,1717595,2200000,3917595
9245,"Earth Girls are Easy",1989,3916303,0,3916303
9246,"Soreike! Anpanman: Omocha no Hoshi no Nanda to …",2016,0,3915932,3915932
9247,"3 amis",2007,0,3915346,3915346
9248,"Kodomo tsukai",2017,0,3912025,3912025
9249,"Resurrection",1980,3910019,0,3910019
9250,"Garde alternée",2017,0,3907930,3907930
9251,"Film Stars Don’t Die in Liverpool",2017,1024266,2883474,3907740
9252,"Reintsurî no kuni",2015,0,3907507,3907507
9253,"Warlock: The Armageddon",1993,3902679,0,3902679
9254,"2:22",2017,422,3900505,3900927
9255,"The Manhattan Project",1986,3900000,0,3900000
9256,"Glyanets",2007,0,3899426,3899426
9257,"Nesokrushimyy",2018,0,3898030,3898030
9258,"Los futbolísimos",2018,0,3897549,3897549
9259,"L'auberge espagnole",2003,3895664,0,3895664
9260,"Swallows and Amazons",2016,0,3895661,3895661
9261,"Clerks",1994,3073428,820812,3894240
9262,"Tian tang kou",2007,0,3887998,3887998
9263,"Loverboy",1989,3887852,0,3887852
9264,"Yoru Wa Mijikashi Aruke Yo Otome",2017,406490,3480413,3886903
9265,"Long zai na li?",2015,0,3883880,3883880
9266,"Man Trouble",1992,3882058,0,3882058
9267,"D'après une histoire vraie",2017,0,3879894,3879894
9268,"Em La Ba Noi Cua Anh",2015,65718,3810953,3876671
9269,"Geukjangpan Hellokabot: Omparoseu Seomui Bimil",2019,0,3872562,3872562
9270,"Rules Don’t Apply",2016,3652206,219242,3871448
9271,"Andre Rieus 2018 Maastricht Concert",2018,0,3869719,3869719
9272,"Soromon no gishou: Kouhen saiban",2015,0,3869485,3869485
9273,"Le goût des merveilles",2015,0,3865682,3865682
9274,"Matrimonio al Sud",2015,0,3862003,3862003
9275,"Wiro Sableng 212",2018,0,3859763,3859763
9276,"You Kill Me",2007,2426851,1432113,3858964
9277,"Throne of Elves",2016,0,3858035,3858035
9278,"Flashpoint",1984,3854833,0,3854833
9279,"The Heavenly Kid",1985,3852271,0,3852271
9280,"The Deep Blue Sea",2012,1126027,2726137,3852164
9281,"Blackmail",2018,0,3849566,3849566
9282,"Django",2017,56556,3790909,3847465
9283,"Petit Paysan",2017,0,3845589,3845589
9284,"Chibi Maruko Chan – A Boy From Italy",2016,0,3844017,3844017
9285,"Niyazi Gül Dörtnala",2015,0,3841737,3841737
9286,"Turist",2014,1359497,2482218,3841715
9287,"First Reformed",2018,3448256,393150,3841406
9288,"Trailer Park Boys: The Movie",2006,3833507,7889,3841396
9289,"Nanatsu no Taizai Movie",2018,0,3840168,3840168
9290,"La donna della mia vita",2010,0,3838596,3838596
9291,"Brick Lane",2008,1094998,2743488,3838486
9292,"Wendy 2 - Freundschaft für Immer",2018,0,3837990,3837990
9293,"Himitsu: The Top Secret",2016,0,3833651,3833651
9294,"Life Stinks",1991,3832400,0,3832400
9295,"Chosun Masoolsa",2015,0,3829088,3829088
9296,"El delfín: La historia de un soñador",2010,0,3828898,3828898
9297,"Lost Highway",1997,3796699,28347,3825046
9298,"To Save a Life",2010,3777210,47658,3824868
9299,"Korô no chi",2018,0,3823511,3823511
9300,"The Laws of the Universe - Part 0",2015,0,3821361,3821361
9301,"Outcast",2015,0,3820123,3820123
9302,"Sin hijos",2015,0,3819914,3819914
9303,"Thanks for Sharing",2013,1066256,2752348,3818604
9304,"Non c'è più religione",2016,0,3817443,3817443
9305,"Benji: Off the Leash!",2004,3817362,0,3817362
9306,"The Real Cancun",2003,3816594,0,3816594
9307,"La corrispondenza",2016,0,3815445,3815445
9308,"Cézanne Et Moi",2016,257597,3557797,3815394
9309,"Go Goa Gone",2013,295414,3515626,3811040
9310,"Better Luck Tomorrow",2003,3802390,6836,3809226
9311,"Green Room",2016,3220371,587132,3807503
9312,"Asahinagu",2017,0,3807061,3807061
9313,"Hide in Plain Sight",1980,3806930,0,3806930
9314,"De Heineken ontvoering",2012,0,3802218,3802218
9315,"Girl Crazy",1943,3800000,0,3800000
9316,"River of No Return",1954,3800000,0,3800000
9317,"Power",1986,3800000,0,3800000
9318,"The Covered Wagon",1923,3800000,0,3800000
9319,"Catfish",2010,3237343,561391,3798734
9320,"Guyana: Crime of the Century",1980,3798102,0,3798102
9321,"Tutta la vita davanti",2008,0,3795187,3795187
9322,"El Amor Menos Pensado",2018,0,3795103,3795103
9323,"Fluke",1995,3794761,0,3794761
9324,"The Governess",1998,3794031,0,3794031
9325,"Free Fire",2017,1799322,1994417,3793739
9326,"Huai Ba Ba",2018,0,3791880,3791880
9327,"Closed Note",2007,0,3790791,3790791
9328,"Sweet Hearts Dance",1988,3790493,0,3790493
9329,"Celeste and Jesse Forever",2012,3103407,684282,3787689
9330,"The Fast Runner",2002,3786801,0,3786801
9331,"jeombaki hanbandoeui gongryong 2 saeroun nakwon",2018,0,3783492,3783492
9332,"Mentiras y Gordas",2009,0,3776883,3776883
9333,"Le fils de l'épicier",2008,276454,3500000,3776454
9334,"Barb Wire",1996,3775952,0,3775952
9335,"Cheech & Chong's The Corsican Brothers",1984,3772785,0,3772785
9336,"Jane Got a Gun",2015,1513793,2257552,3771345
9337,"Merci Patron!",2016,0,3770001,3770001
9338,"The Monster Squad",1987,3769990,0,3769990
9339,"Nitro",2007,3768878,0,3768878
9340,"Cleaner",2008,0,3768452,3768452
9341,"Chamboultout",2019,0,3766231,3766231
9342,"When Time Ran Out...",1980,3763988,0,3763988
9343,"Saraba seishun, saredo seishun",2018,0,3762474,3762474
9344,"Zemletryasenie",2016,0,3757826,3757826
9345,"Ange et Gabrielle",2015,0,3757716,3757716
9346,"Boychoir",2015,366474,3389064,3755538
9347,"Imagine: John Lennon",1988,3753977,0,3753977
9348,"What We Did on Our Holiday",2014,4200,3749765,3753965
9349,"Feeling Minnesota",1996,3124440,628006,3752446
9350,"Allan Quatermain and the Lost City",1987,3751699,0,3751699
9351,"The Connection",2018,0,3748305,3748305
9352,"Detachment",2012,70740,3671957,3742697
9353,"Room",2006,5228,3737293,3742521
9354,"Love Without Words",2017,0,3741863,3741863
9355,"Les dents, pipi et au lit",2018,0,3741800,3741800
9356,"Up at the Villa",2000,2933161,806952,3740113
9357,"Hedwig and the Angry Inch",2001,3067312,672718,3740030
9358,"Exterminator 2",1984,3739406,0,3739406
9359,"The Ex",2007,3091922,646700,3738622
9360,"Diverso Da Chi",2009,0,3738076,3738076
9361,"Leviafan",2014,1092800,2644143,3736943
9362,"Born Into Brothels: Calcutta's Red Light Kids",2004,3430117,305852,3735969
9363,"Buddha",2011,0,3734904,3734904
9364,"Wildlife",2018,1030174,2703923,3734097
9365,"Un beau soleil intérieur",2017,866714,2866025,3732739
9366,"Liberty Heights",1999,3732398,0,3732398
9367,"Drôles de petites bêtes",2017,0,3730616,3730616
9368,"Una mujer fantástica",2017,2019554,1710922,3730476
9369,"Born to be Wild",1995,3730409,0,3730409
9370,"Coffee and Cigarettes",2004,1971135,1758671,3729806
9371,"Like Crazy",2011,3395391,333009,3728400
9372,"By the Sea",2015,538460,3189286,3727746
9373,"Volki i ovtsy",2016,0,3722545,3722545
9374,"Machine Gun Preacher",2011,538690,3183298,3721988
9375,"The Big Kahuna",2000,3150107,563344,3713451
9376,"BloodRayne",2006,2405420,1306213,3711633
9377,"Jekyll and Hyde... Together Again",1982,3707583,0,3707583
9378,"The Secret Lives of Dentists",2003,3707201,0,3707201
9379,"Thirteen Conversations About One Thing",2002,3287435,418488,3705923
9380,"Spare Parts",2015,3618912,82369,3701281
9381,"L'Invité",2007,0,3700903,3700903
9382,"Thomas & Friends: The Great Race",2016,0,3700794,3700794
9383,"The Brother from Another Planet",1984,3700000,0,3700000
9384,"The Day the Earth Stood Still",1951,3700000,0,3700000
9385,"Holiday in Mexico",1946,3700000,0,3700000
9386,"A Date with Judy",1948,3700000,0,3700000
9387,"The Singing Nun",1966,3700000,0,3700000
9388,"The Portrait of a Lady",1996,3698012,0,3698012
9389,"Phoenix Forgotten",2017,3600146,97583,3697729
9390,"Brothers of the Wind",2015,0,3697220,3697220
9391,"Nessuno si salva da solo",2015,0,3695945,3695945
9392,"Honkytonk Man",1982,3695409,0,3695409
9393,"Cockpit",2012,0,3692388,3692388
9394,"Rokjesdag",2016,0,3690853,3690853
9395,"Worth Winning",1989,3690328,0,3690328
9396,"7 Nyeonui Bam",2018,0,3690265,3690265
9397,"Pork Chop Hill",1959,3690000,0,3690000
9398,"Feng men gui ying",2015,0,3690000,3690000
9399,"Fitoor",2016,528799,3159295,3688094
9400,"Three O’Clock High",1987,3685862,0,3685862
9401,"Yusuf Yusuf",2014,0,3685671,3685671
9402,"The Cut",2007,0,3684688,3684688
9403,"Yi Qie Dou Hao",2016,0,3680000,3680000
9404,"Gosnell: The Trial of America’s Biggest Serial …",2018,3679893,0,3679893
9405,"Faccio Un Salto All'Avana",2011,0,3677715,3677715
9406,"Tsubaki Sanjûrô",2007,0,3675205,3675205
9407,"Arctic",2019,2353563,1317465,3671028
9408,"Jimmy Hollywood",1994,3670865,0,3670865
9409,"The Grand Seduction",2014,3409304,260554,3669858
9410,"Tian Sheng Bu Dui",2017,0,3667477,3667477
9411,"Made in Italy",2018,0,3666004,3666004
9412,"The Keep",1983,3661757,0,3661757
9413,"Days of Heaven",1978,3446749,214131,3660880
9414,"The Blood Hound",2017,0,3660871,3660871
9415,"Vanishing Time: A Boy Who Returned",2016,0,3655624,3655624
9416,"Les déguns",2018,0,3652697,3652697
9417,"The Storm Rider",2008,0,3651400,3651400
9418,"Rokku: Wanko No Shima",2011,0,3646866,3646866
9419,"A La Mala",2015,3629842,16785,3646627
9420,"Owatta hito",2018,0,3646535,3646535
9421,"Miss Saigon 25th Anniversary Performance",2016,0,3646351,3646351
9422,"5 Flights Up",2015,1020921,2624412,3645333
9423,"VIPs",2010,0,3642459,3642459
9424,"Skjelvet",2018,6235,3635843,3642078
9425,"Rafadan Tayfa Dehliz Macerasi",2018,0,3639308,3639308
9426,"Lo contrario al amor",2011,0,3639100,3639100
9427,"Indignation",2016,3401155,234370,3635525
9428,"Jeepers Creepers 3",2017,2235162,1399273,3634435
9429,"Mo Er Zhuang Yuan 2: Hai Yao Bao Cang",2012,0,3633141,3633141
9430,"My Architect",2003,2822522,801436,3623958
9431,"The Iceman",2013,1930282,1693327,3623609
9432,"White Man's Burden",1995,3622433,0,3622433
9433,"El Bar",2017,0,3622317,3622317
9434,"Lesbian Vampire Killers",2009,0,3620902,3620902
9435,"Big Game",2015,24752,3595577,3620329
9436,"Naam Hai Akira",2016,219401,3399570,3618971
9437,"The Final Cut",2004,548039,3070786,3618825
9438,"The Killer Inside Me",2010,217277,3400000,3617277
9439,"Um Suburbano Sortudo",2016,0,3610588,3610588
9440,"Tout schuss",2016,0,3609698,3609698
9441,"Gidam",2009,0,3608964,3608964
9442,"Crime d'amour ",2011,539792,3068869,3608661
9443,"The Trigger Effect",1996,3608238,0,3608238
9444,"24 Hour Party People",2002,1169030,2435935,3604965
9445,"My Heroes Have Always Been Cowboys",1991,3603615,0,3603615
9446,"Pettersson und Findus 2 - Das schönste Weihnach…",2016,0,3601448,3601448
9447,"Wrong is Right",1982,3600000,0,3600000
9448,"This Time for Keeps",1947,3600000,0,3600000
9449,"Ziegfeld Follies",1945,3600000,0,3600000
9450,"The Bride",1985,3600000,0,3600000
9451,"Two Sisters from Boston",1946,3600000,0,3600000
9452,"Genghis Blues",1999,3599174,0,3599174
9453,"Bordertown",2008,0,3598262,3598262
9454,"Finding Vivian Maier",2014,1509131,2087419,3596550
9455,"La traviata",1983,3594000,0,3594000
9456,"Chimmuk",2017,0,3593741,3593741
9457,"Tabineko ripoto",2018,0,3593634,3593634
9458,"The Gun in Betty Lou's Handbag",1992,3591460,0,3591460
9459,"Toivon Tuolla Puolen",2017,184090,3406400,3590490
9460,"What If",2014,3493000,97207,3590207
9461,"Bao zou shen tan",2015,0,3590092,3590092
9462,"Yuan Ling Ren Ou",2014,0,3590000,3590000
9463,"Dead Heat",1988,3588626,0,3588626
9464,"Cats Don't Dance",1997,3588602,0,3588602
9465,"Indivisible",2018,3511417,76888,3588305
9466,"Fireflies in the Garden",2011,36884,3550307,3587191
9467,"Ikigami",2008,0,3585144,3585144
9468,"Raabta",2017,0,3582830,3582830
9469,"The Secret of Kells",2010,690290,2892507,3582797
9470,"Destroyer",2018,1533324,2047517,3580841
9471,"Holy Smoke",1999,1758780,1821943,3580723
9472,"The Door of Happiness",2014,0,3580000,3580000
9473,"Cruising Bar 2",2008,3579013,0,3579013
9474,"Bao Bei Er",2018,0,3576269,3576269
9475,"Sidewalks of New York",2001,2402459,1172849,3575308
9476,"The Jane Austen Book Club",2007,3575227,0,3575227
9477,"Old Gringo",1989,3574256,0,3574256
9478,"Guddo môningu shô",2016,0,3573355,3573355
9479,"Frog Kingdom",2013,0,3573180,3573180
9480,"American Anthem",1986,3571624,0,3571624
9481,"Pieces of April",2003,2528664,1042589,3571253
9482,"Le gendre de ma vie",2018,0,3570142,3570142
9483,"The New Adventures of Pippi Longstocking",1988,3569939,0,3569939
9484,"Io che amo solo te",2015,0,3569880,3569880
9485,"Au bout des doigts",2018,0,3569690,3569690
9486,"Hitsuji to hagane no mori",2018,0,3567409,3567409
9487,"All You Need Is Love",2014,0,3565259,3565259
9488,"Sevimli Tehlikeli",2015,0,3564246,3564246
9489,"Turk 182!",1985,3563635,0,3563635
9490,"Fat Man and Little Boy",1989,3560942,0,3560942
9491,"Tom and Jerry: The Movie",1993,3560469,0,3560469
9492,"L’apparition",2018,28293,3532036,3560329
9493,"The Neon Demon",2016,1333124,2226679,3559803
9494,"Gekijoban Kamen Raida Den'o and Kiba Kuraimakku…",2008,0,3558763,3558763
9495,"Un peu, beaucoup, aveuglément!",2015,0,3557353,3557353
9496,"Nintama Rantaro",2011,0,3555453,3555453
9497,"Junebug",2005,2678010,875243,3553253
9498,"Major League: Back to the Minors",1998,3551208,0,3551208
9499,"Byeonsan",2018,0,3550880,3550880
9500,"Madame Sousatzka",1988,3548000,0,3548000
9501,"Kizumonogatari II: Nekketsu-hen",2016,0,3544991,3544991
9502,"Un altro mondo",2010,0,3544674,3544674
9503,"Fan",2016,1689879,1852924,3542803
9504,"The Joneses",2010,1475746,2065819,3541565
9505,"Testosteron (Poland, 2007)",2007,0,3540470,3540470
9506,"Kolonya Cumhuriyeti",2017,0,3540420,3540420
9507,"New Jersey Drive",1995,3540207,0,3540207
9508,"Jusqu'à la garde",2018,83882,3455988,3539870
9509,"Granny's Got Talent",2015,0,3535083,3535083
9510,"The Challenge",1982,3534852,0,3534852
9511,"Prey",2007,0,3533999,3533999
9512,"The Pest",1997,3533790,0,3533790
9513,"El desconocido",2015,0,3532967,3532967
9514,"In Country",1989,3531971,0,3531971
9515,"2019 Oscar Shorts",2019,3531093,0,3531093
9516,"Things Change",1988,3527886,0,3527886
9517,"Til There Was You",1997,3525125,0,3525125
9518,"Nomitori samurai",2018,0,3524012,3524012
9519,"Bad Company",1995,3523909,0,3523909
9520,"The Paperboy",2012,677200,2844953,3522153
9521,"Free Willy 3: The Rescue",1997,3519178,0,3519178
9522,"Bleach",2018,0,3517531,3517531
9523,"Per un pugno di dollari",1967,3500000,16248,3516248
9524,"2018 Oscar Shorts",2018,3508777,2345,3511122
9525,"Kamen Raidâ × Supâ Sentai Chô Supâ Hîrô Taisen…",2017,0,3511088,3511088
9526,"Jour J",2017,0,3510496,3510496
9527,"Ek Ladki Ko Dekhah Toh Aisa Laga",2019,1182636,2327796,3510432
9528,"The Tall Guy",1990,510000,3000000,3510000
9529,"Neruda",2016,939099,2570792,3509891
9530,"Ladrones",2015,3063505,440909,3504414
9531,"The Disappointments Room",2016,2423467,1080294,3503761
9532,"Le petit Spirou",2017,0,3501986,3501986
9533,"Thousands Cheer",1943,3500000,0,3500000
9534,"Fiesta",1947,3500000,0,3500000
9535,"Bathing Beauty",1944,3500000,0,3500000
9536,"Deep in My Heart",1954,3500000,0,3500000
9537,"Two Girls and a Sailor",1944,3500000,0,3500000
9538,"Words and Music",1948,3500000,0,3500000
9539,"State Fair",1962,3500000,0,3500000
9540,"Casanova's Big Night",1954,3500000,0,3500000
9541,"The Glacier Fox",1979,3500000,0,3500000
9542,"The Wraith",1986,3500000,0,3500000
9543,"Mei Li Ren Sheng",2011,66171,3428950,3495121
9544,"American Animals",2018,2853526,639691,3493217
9545,"Premières vacances",2019,0,3492817,3492817
9546,"The Three Pigs and the Lamp",2015,0,3492035,3492035
9547,"Kara Bela",2015,0,3490241,3490241
9548,"El Greco",2007,0,3489694,3489694
9549,"Thomas & Friends: Sodor's Legend of the Lost Tr…",2015,0,3487449,3487449
9550,"Jeffrey",1995,3487000,0,3487000
9551,"Veronica Mars",2014,3322127,163256,3485383
9552,"Doris",2018,0,3485105,3485105
9553,"Heaven's Gate",1980,3484331,192,3484523
9554,"Bully",2012,3483795,0,3483795
9555,"Camping Sauvage",2004,3479302,0,3479302
9556,"Viva La Liberta",2013,49071,3429059,3478130
9557,"Cabin Boy",1994,3469493,0,3469493
9558,"Talk Radio",1988,3468572,0,3468572
9559,"Next Stop Wonderland",1998,3395581,70122,3465703
9560,"Shout",1991,3463620,0,3463620
9561,"Bheja Fry 2",2011,22266,3441323,3463589
9562,"Ola de Crímenes",2018,0,3463410,3463410
9563,"Smetto Quando Voglio - Masterclass",2017,0,3462915,3462915
9564,"Krrish 3",2013,2123333,1335055,3458388
9565,"Eiga Purikyua Dorimu Sutazu!",2017,0,3457773,3457773
9566,"Shattered Glass",2003,2207975,1248627,3456602
9567,"The Trip",2011,2030962,1424259,3455221
9568,"Jean de Florette",1987,3452836,0,3452836
9569,"Vykradena pryntsesa: Ruslan i Ludmila",2018,0,3452162,3452162
9570,"B Jia Zhen Tan",2011,0,3451602,3451602
9571,"Neptune's Daughter",1949,3450000,0,3450000
9572,"Les têtes de l'emploi",2016,0,3444421,3444421
9573,"Rock On",2008,0,3443103,3443103
9574,"Moll Flanders",1996,3443047,0,3443047
9575,"Beneath Hill 60",2014,0,3440939,3440939
9576,"Full Frontal",2002,2512846,925958,3438804
9577,"The Ultimate Gift",2007,3438735,0,3438735
9578,"Irina Palm",2008,44064,3392960,3437024
9579,"Bathory",2008,0,3436763,3436763
9580,"Price of Glory",2000,3434515,0,3434515
9581,"Boule et Bill 2",2017,0,3433585,3433585
9582,"Pancho, el perro millonario",2014,0,3431073,3431073
9583,"Istanbul Kirmizisi",2017,0,3430854,3430854
9584,"Malena",2000,3429045,0,3429045
9585,"Trezviy voditel",2019,0,3427532,3427532
9586,"Gunmen",1994,3426347,0,3426347
9587,"Til Death Do Us Part",2017,3424454,0,3424454
9588,"On Chesil Beach",2018,745972,2674367,3420339
9589,"A Shock to the System",1990,3417056,0,3417056
9590,"Hanni & Nanni: Mehr als beste Freunde",2017,0,3415880,3415880
9591,"The Rider",2018,2418679,996024,3414703
9592,"Jinsei no yakusoku",2016,0,3409317,3409317
9593,"A Simple Twist of Fate",1994,3404935,0,3404935
9594,"Chernovik",2018,0,3403021,3403021
9595,"Born American",1986,3401376,0,3401376
9596,"In the Good Old Summertime",1949,3400000,0,3400000
9597,"Maytime",1937,3400000,0,3400000
9598,"The Lemon Sisters",1990,3399773,0,3399773
9599,"The MatchMaker",1997,3398083,0,3398083
9600,"Lezioni di Cioccolato",2007,0,3397829,3397829
9601,"The Company",2003,2281585,1114923,3396508
9602,"Head Office",1986,3393807,0,3393807
9603,"Angels and Insects",1996,3390811,0,3390811
9604,"Sgt. Stubby: An American Hero",2018,3054285,336309,3390594
9605,"Gom Taeng I",2018,0,3388675,3388675
9606,"Rock the Kasbah",2015,3020665,365488,3386153
9607,"Bruder vor Luder",2015,0,3378311,3378311
9608,"Is Anybody There?",2009,2026756,1351022,3377778
9609,"Dear Zindagi",2016,2376479,999896,3376375
9610,"Jia Nian Hua",2017,0,3375245,3375245
9611,"The Ugly Duckling",2016,0,3375129,3375129
9612,"Sagan",2008,0,3375087,3375087
9613,"Curse of the Pink Panther",1983,3374312,0,3374312
9614,"Near Dark",1987,3369307,0,3369307
9615,"Rivers and Tides",2002,2200276,1168274,3368550
9616,"Nautanki Saala!",2013,0,3367990,3367990
9617,"Starchaser: The Legend of Orin",1985,3360800,0,3360800
9618,"The School of Flesh",1999,3359031,0,3359031
9619,"Crash",1996,3357324,0,3357324
9620,"Paradise Now",2005,1452402,1904673,3357075
9621,"Head in the Clouds",2004,398179,2958074,3356253
9622,"Shuriken Sentai Ninninja tai Ressha Sentai Tokk…",2016,0,3355599,3355599
9623,"Unknown",2006,26403,3328645,3355048
9624,"Belles familles",2015,0,3353776,3353776
9625,"Mortadelo y Filemón contra Jimmy el Cachondo",2014,0,3350943,3350943
9626,"Odnoy levoy",2015,0,3350205,3350205
9627,"Together",2001,1034829,2315099,3349928
9628,"My One and Only",2009,2556558,792396,3348954
9629,"The Work and the Glory",2004,3347647,0,3347647
9630,"Words and Pictures",2014,2171257,1174538,3345795
9631,"Oldboy",2013,2193658,1149909,3343567
9632,"Atlas Shrugged: Part II",2012,3336053,0,3336053
9633,"Russkiy kovcheg",2002,3092976,242524,3335500
9634,"The Last Kiss",2002,1048950,2286227,3335177
9635,"La Llamada",2017,0,3334804,3334804
9636,"Fraternity Vacation",1985,3333306,0,3333306
9637,"Black Sea",2015,1171559,2160512,3332071
9638,"Camille Claudel",1989,3331297,0,3331297
9639,"The Wackness",2008,2077046,1252966,3330012
9640,"Alibaba Solomons Seal",2016,0,3330000,3330000
9641,"Fifty",1999,3328240,0,3328240
9642,"U Me Aur Hum",2008,1028191,2300000,3328191
9643,"La Tourneuse de Pages",2007,208691,3117246,3325937
9644,"Maskeli Besler",2007,0,3325862,3325862
9645,"Carpool",1996,3325651,0,3325651
9646,"Les deux mondes",2007,0,3325436,3325436
9647,"Girls und Panzer The FILM",2016,0,3324526,3324526
9648,"Heist",2015,50136,3273995,3324131
9649,"Obvious Child",2014,3122616,201454,3324070
9650,"Porady na zdrady",2017,0,3322224,3322224
9651,"Pâfekuto wârudo",2018,0,3320638,3320638
9652,"La deuxième étoile",2017,0,3320313,3320313
9653,"Perdiendo el este",2019,0,3319871,3319871
9654,"Eiga Yes! PreCure 5: Kagami no Kuni no Miracle …",2007,0,3319368,3319368
9655,"Squanto: A Warrior's Tale",1994,3319344,0,3319344
9656,"A Smile Like Yours",1997,3317930,0,3317930
9657,"13",2011,0,3317662,3317662
9658,"Elvis Gratton 2",1999,3316272,0,3316272
9659,"20,000 Days on Earth",2014,279558,3034841,3314399
9660,"Ti presento Sofia",2018,0,3311729,3311729
9661,"Gye chun hal mang",2016,0,3311026,3311026
9662,"Last Ounce of Courage",2012,3310439,0,3310439
9663,"Warrior’s Gate",2016,0,3303741,3303741
9664,"Omar M’a Teur",2011,0,3303155,3303155
9665,"Wondeopul Goseuteu",2018,0,3301620,3301620
9666,"Mannequin: On the Move",1991,3300609,0,3300609
9667,"Raaz 2: The Mystery Continues",2009,0,3300000,3300000
9668,"Hui Ma Ting",2016,0,3300000,3300000
9669,"Happily Ever After",1993,3299382,0,3299382
9670,"Penguins",2019,3298757,0,3298757
9671,"Art School Confidential",2006,3297137,0,3297137
9672,"Pootie Tang",2001,3293258,0,3293258
9673,"Riding Giants",2004,2276368,1015965,3292333
9674,"Dust",2017,0,3288150,3288150
9675,"Godzilla: Planet of the Monsters",2017,0,3285291,3285291
9676,"Bluff Master",2005,718956,2566200,3285156
9677,"The Reef 2: High Tide",2012,0,3283366,3283366
9678,"A Dry White Season",1989,3282890,0,3282890
9679,"Let's Spend the Night Together",1983,3282561,0,3282561
9680,"Provoked: A True Story",2007,918931,2363338,3282269
9681,"Sunshine State",2002,3064356,217542,3281898
9682,"Colonia",2016,15709,3266146,3281855
9683,"Blue Sky",1994,3281813,0,3281813
9684,"Looker",1981,3281232,0,3281232
9685,"Original Gangstas",1996,3279266,0,3279266
9686,"Ten Canoes",2007,277991,3000000,3277991
9687,"Tamara Vol. 2",2018,0,3277932,3277932
9688,"Romeo Is Bleeding",1994,3275585,0,3275585
9689,"Only the Strong",1993,3273588,0,3273588
9690,"Fünf Freunde und das Tal der Dinosaurier",2018,0,3273025,3273025
9691,"Vertigo",1958,3200000,71996,3271996
9692,"Grupo 7",2012,0,3271403,3271403
9693,"Natale da Chef",2017,0,3270987,3270987
9694,"Pathology",2008,109045,3161929,3270974
9695,"The Glass Shield",1995,3270822,0,3270822
9696,"Tadpole",2002,2891288,378840,3270128
9697,"Mi Vida Loca",1994,3269420,0,3269420
9698,"Father Hood",1993,3268203,0,3268203
9699,"Die Häschenschule: Jagd nach dem goldenen Ei",2017,0,3266954,3266954
9700,"L’insulte",2017,1000038,2264873,3264911
9701,"Don’t Worry, He Won’t Get Far on Foot",2018,1441705,1822124,3263829
9702,"Mrs. Dalloway",1998,3263672,0,3263672
9703,"Death Before Dishonor",1987,3261973,0,3261973
9704,"Pinocchio and the Emperor of the Night",1987,3261638,0,3261638
9705,"Resurrecting the Champ",2007,3172382,88173,3260555
9706,"Peaceful Warrior",2006,2893666,366513,3260179
9707,"Loufa Kai Apallagi - I4",2008,0,3258957,3258957
9708,"Borg vs McEnroe",2017,231346,3026576,3257922
9709,"12 Golden Ducks",2015,0,3256270,3256270
9710,"Clifford's Really Big Movie",2004,2922354,333072,3255426
9711,"China Cry: A True Story",1990,3254801,0,3254801
9712,"Serce nie sluga",2018,0,3254769,3254769
9713,"The Son",2003,70034,3183975,3254009
9714,"Po strništi bos",2017,0,3253638,3253638
9715,"Supercross",2005,3102550,150000,3252550
9716,"Linda de Morrer",2015,0,3251792,3251792
9717,"Robin des Bois, la véritable histoire",2015,0,3251375,3251375
9718,"Ok Jaanu",2017,355922,2894924,3250846
9719,"Po prostu przyjazn",2017,0,3250422,3250422
9720,"Mayweather vs. McGregor",2017,2620183,629836,3250019
9721,"Monster Strike The Movie: Sora no Kanata",2018,0,3249907,3249907
9722,"Gymkata",1985,3249442,0,3249442
9723,"Que Horas Ela Volta?",2015,376976,2872065,3249041
9724,"Splitting Heirs",1993,3246063,0,3246063
9725,"Mr. X",2015,44995,3200000,3244995
9726,"Breath",2018,37109,3206203,3243312
9727,"Carrington",1995,3242342,0,3242342
9728,"Yi ge shao zi",2015,8212,3233041,3241253
9729,"Huisvrouwen Bestaan Niet",2017,0,3239032,3239032
9730,"The Edge of Love",2009,33260,3205662,3238922
9731,"Letters to God",2010,2848587,388865,3237452
9732,"Kidnapping Mr. Heineken",2015,0,3237282,3237282
9733,"The Adventures of Wei Bao Bao",2016,0,3233185,3233185
9734,"The Imposter",2012,901954,2330763,3232717
9735,"Romance and Cigarettes",2007,551002,2680249,3231251
9736,"Gekijouban Yowamushi pedaru",2015,0,3230701,3230701
9737,"Crooked House",2017,0,3230144,3230144
9738,"Dachimawa Lee",2008,0,3229037,3229037
9739,"Little Fish",2006,22453,3200000,3222453
9740,"Brad’s Status",2017,2133158,1088375,3221533
9741,"Barfly",1987,3221000,0,3221000
9742,"En équilibre",2015,3144,3217766,3220910
9743,"Andre Rieu's 2016 Maastricht Concert",2016,0,3220727,3220727
9744,"Il nome del figlio",2015,0,3219309,3219309
9745,"My Boyfriend's Back",1993,3218882,0,3218882
9746,"The Wild Parrots of Telegraph Hill",2005,3058527,160182,3218709
9747,"Under sandet",2015,434640,2777749,3212389
9748,"Maria Larssons eviga ögonblick",2009,610825,2600000,3210825
9749,"The Boys are Back",2009,809752,2400000,3209752
9750,"Braqueurs",2016,0,3209685,3209685
9751,"Traces of Red",1992,3206713,0,3206713
9752,"Qualquer Gato Vira-Lata 2",2015,0,3204018,3204018
9753,"Saint Amour",2016,0,3203410,3203410
9754,"Top Hat",1935,1782000,1420000,3202000
9755,"La Delicatesse",2012,0,3200055,3200055
9756,"Road to Singapore",1940,3200000,0,3200000
9757,"On an Island with You",1948,3200000,0,3200000
9758,"Murder 3",2013,0,3200000,3200000
9759,"Radio Star",2006,0,3199863,3199863
9760,"Maurice",1987,3147950,50358,3198308
9761,"Stonehearst Asylum",2014,0,3197693,3197693
9762,"Mon garçon",2017,0,3197525,3197525
9763,"Penguin Highway",2018,0,3194707,3194707
9764,"Onze Jongens",2016,0,3193629,3193629
9765,"L'Embarras Du Choix",2017,0,3193308,3193308
9766,"Voyez comme on danse",2018,0,3191370,3191370
9767,"The Front Runner",2018,1994179,1194422,3188601
9768,"Voin",2015,0,3187750,3187750
9769,"Thoroughbreds",2018,3072605,114697,3187302
9770,"Rosewater",2014,3128941,56776,3185717
9771,"El hilo rojo",2016,0,3184052,3184052
9772,"Enemies In-Law",2015,0,3181670,3181670
9773,"Sunsu-ui sidae",2015,0,3180514,3180514
9774,"The Rover",2014,1109199,2071053,3180252
9775,"Silent Fall",1994,3180000,0,3180000
9776,"Le sens de l’humour",2011,3179193,0,3179193
9777,"Ladda Land",2010,0,3178768,3178768
9778,"Gentleman: Sundar, Susheel, Risky",2017,410055,2768214,3178269
9779,"Wordplay",2006,3121270,56366,3177636
9780,"Mannenharten 2",2015,0,3177522,3177522
9781,"The Cat's Meow",2002,3176936,0,3176936
9782,"Ride",2000,3176650,0,3176650
9783,"Haeuhhwa",2016,0,3174887,3174887
9784,"Ingrid Goes West",2017,3021133,152069,3173202
9785,"Factotum",2006,808221,2362800,3171021
9786,"Rude Awakening",1989,3169719,0,3169719
9787,"Das schönste Mädchen der Welt",2018,0,3168150,3168150
9788,"The Winter's Tale",2015,0,3164827,3164827
9789,"Fuera De Carta",2008,0,3162337,3162337
9790,"Over Drive",2018,0,3161652,3161652
9791,"Magic Mirror 2",2018,0,3161317,3161317
9792,"My Mom's New Boyfriend",2008,0,3161218,3161218
9793,"Provoking Laughter",2016,0,3160000,3160000
9794,"Love Me Love My Dog",2015,0,3160000,3160000
9795,"The Bad Education Movie",2015,0,3159919,3159919
9796,"Nos 18 ans",2008,0,3156149,3156149
9797,"Heung-boo: The Revolutionist",2018,0,3155672,3155672
9798,"Kak ya stal russkim",2019,0,3154206,3154206
9799,"Newton",2017,0,3152554,3152554
9800,"Raw",2017,514870,2637090,3151960
9801,"Steal Big, Steal Little",1995,3150170,0,3150170
9802,"Nadide Hayat",2015,0,3148074,3148074
9803,"Küçük Esnaf",2016,0,3140557,3140557
9804,"In a World...",2013,2963271,175940,3139211
9805,"Fuga da Reuma Park",2016,0,3138098,3138098
9806,"Beautiful",2000,3134509,0,3134509
9807,"We are X",2016,45270,3087216,3132486
9808,"Monsieur Je-Sais-Tout",2018,0,3131371,3131371
9809,"Imagine Me & You",2006,672243,2457228,3129471
9810,"Boynton Beach Club",2006,3127472,0,3127472
9811,"1921",2018,0,3126687,3126687
9812,"Mr. Wonderful",1993,3125000,0,3125000
9813,"The End of the Tour",2015,3002883,111460,3114343
9814,"Bandeusi Japeunda",2017,0,3112906,3112906
9815,"Hibiki - shôsetsuka ni naru hôhô",2018,0,3111540,3111540
9816,"Coogan's Bluff",1968,3110000,0,3110000
9817,"White Mischief",1988,3107000,0,3107000
9818,"Girl Happy",1965,3100000,0,3100000
9819,"The Legend of Billie Jean",1985,3100000,0,3100000
9820,"The Last House on the Left",1972,3100000,0,3100000
9821,"Dear Frankie",2005,1340891,1758478,3099369
9822,"The Favor",1994,3098590,0,3098590
9823,"Moje córki krowy",2016,0,3097650,3097650
9824,"Andre Rieu's 2017 Maastricht Concert",2017,0,3097621,3097621
9825,"Rasuto koppu: The Movie",2017,0,3096923,3096923
9826,"American Adobo",2002,3094699,0,3094699
9827,"Wakolda",2013,414912,2676288,3091200
9828,"Le doudou",2018,0,3091100,3091100
9829,"Your Sister's Sister",2012,1597486,1493107,3090593
9830,"Clouds of Sils Maria",2014,1841555,1246984,3088539
9831,"Kinjite",1989,3088086,0,3088086
9832,"Que Dios nos perdone",2016,0,3087264,3087264
9833,"Nothing Like a Dame",2018,867903,2217624,3085527
9834,"A Private War",2018,1633209,1446610,3079819
9835,"La Moustache",2006,244771,2833553,3078324
9836,"King of Prism: Pride the Hero",2017,0,3078057,3078057
9837,"Princess Caraboo",1994,2984777,92578,3077355
9838,"Speed Zone!",1989,3077061,0,3077061
9839,"Jawbreaker",1999,3076820,0,3076820
9840,"Dominick and Eugene",1988,3076031,0,3076031
9841,"Paid in Full",2002,3042188,32864,3075052
9842,"Messenger of Death",1988,3074681,0,3074681
9843,"L'échange des princesses",2017,0,3072680,3072680
9844,"Wu Jia Zhi Bao",2011,0,3071161,3071161
9845,"Les Fantômes d'Ismaël",2017,102510,2968155,3070665
9846,"The Resident",2012,0,3069729,3069729
9847,"Spasti Leningrad",2019,0,3068838,3068838
9848,"Das Tagebuch der Anne Frank",2016,0,3068175,3068175
9849,"The Public Eye",1992,3067917,0,3067917
9850,"Mauvaises herbes",2018,0,3067900,3067900
9851,"Sei mai stata sulla luna?",2015,0,3065820,3065820
9852,"Hit and Run",2009,0,3064804,3064804
9853,"Tristram Shandy: A Cock and Bull Story",2006,1253413,1808350,3061763
9854,"Crumb",1995,3041083,19577,3060660
9855,"Gaeleul hoomchineun wanbyeokhan bangbeob",2014,0,3059215,3059215
9856,"Everything About Her",2016,0,3058834,3058834
9857,"The Widow of St. Pierre",2001,3058380,0,3058380
9858,"Man Up",2015,0,3056781,3056781
9859,"Illegal Tender",2007,3054430,0,3054430
9860,"Milosc jest wszystkim",2018,0,3053690,3053690
9861,"Songcatcher",2001,3050934,0,3050934
9862,"Une intime conviction",2019,0,3047270,3047270
9863,"Stories We Tell",2012,1602160,1441557,3043717
9864,"K2",1992,3042892,0,3042892
9865,"Ragini MMS",2014,0,3042374,3042374
9866,"Der Staat gegen Fritz Bauer",2015,288434,2752337,3040771
9867,"Fate",2007,0,3040410,3040410
9868,"The Mother",2004,1062253,1976424,3038677
9869,"China Moon",1991,3038499,0,3038499
9870,"Death and the Maiden",1994,3038495,0,3038495
9871,"The Golden Bowl",2001,3037579,0,3037579
9872,"Je Vais Bien, Ne T'en Fais Pas",2006,0,3036690,3036690
9873,"Survivre avec les Loups",2007,0,3033368,3033368
9874,"Lianhua Xingdong",2015,0,3030000,3030000
9875,"Leto",2018,0,3029398,3029398
9876,"The East",2013,2274649,753307,3027956
9877,"Bonsai",2012,21163,3006266,3027429
9878,"Pao Fu Xiao Jie",2018,0,3026917,3026917
9879,"The Last Days of Disco",1998,3024198,0,3024198
9880,"Amour & turbulences",2013,8425,3013877,3022302
9881,"G",2005,3020784,0,3020784
9882,"Anacleto: Agente secreto",2015,0,3020332,3020332
9883,"Un Natale al Sud",2016,0,3018782,3018782
9884,"Hate Story IV",2018,0,3018102,3018102
9885,"Still of the Night",1982,3017965,0,3017965
9886,"Fighting Back",1982,3016496,0,3016496
9887,"El Hombre de las mil caras",2016,0,3013266,3013266
9888,"Ah Fei Ching Chuen",1990,141864,2870940,3012804
9889,"Trailer Park Boys: Countdown to Liquor Day",2009,3012677,0,3012677
9890,"Bez granits",2015,0,3008046,3008046
9891,"The Philadelphia Story",1940,3000000,7079,3007079
9892,"Thaandavam",2012,213476,2793326,3006802
9893,"Ju-On: The Grudge",2004,325661,2679887,3005548
9894,"Zomboyachik",2018,0,3004952,3004952
9895,"Fighting Men of China",2018,0,3004460,3004460
9896,"Monsieur Papa",2011,0,3001987,3001987
9897,"Sorte Kugler",2009,0,3001084,3001084
9898,"Yi ju ding yi wan ju",2016,0,3000904,3000904
9899,"Feds",1988,3000000,0,3000000
9900,"Forbidden Planet",1956,3000000,0,3000000
9901,"Myra Breckinridge",1970,3000000,0,3000000
9902,"Big Shots",1987,3000000,0,3000000
9903,"Hanover Street",1979,3000000,0,3000000
9904,"The World in His Arms",1952,3000000,0,3000000
9905,"Speedway",1968,3000000,0,3000000
9906,"Roustabout",1964,3000000,0,3000000
9907,"Lost Horizon",1973,3000000,0,3000000
9908,"Critters 2: The Main Course",1988,3000000,0,3000000
9909,"Macumba Love",1960,3000000,0,3000000
9910,"The Bandit of Sherwood Forest",1946,3000000,0,3000000
9911,"Over the Hill to the Poorhouse",1920,3000000,0,3000000
9912,"Aloma of the South Seas",1926,3000000,0,3000000
9913,"Without Reservations",1946,3000000,0,3000000
9914,"Le grand bleu",1988,3000000,0,3000000
9915,"Malone",1987,3000000,0,3000000
9916,"Le dernier métro",1981,3000000,0,3000000
9917,"Sweethearts",1938,3000000,0,3000000
9918,"Honky Tonk",1941,3000000,0,3000000
9919,"The Jazz Singer",1927,3000000,0,3000000
9920,"My Demon Lover",1987,3000000,0,3000000
9921,"Mirage",1965,3000000,0,3000000
9922,"Westworld",1973,3000000,0,3000000
9923,"That's Entertainment part 2",1976,3000000,0,3000000
9924,"The Great Ziegfeld",1936,3000000,0,3000000
9925,"Waikiki Wedding",1937,3000000,0,3000000
9926,"Feng kuang de shi tou",2006,0,3000000,3000000
9927,"Dva Khvosta",2018,0,2998399,2998399
9928,"Mission Istaanbul",2008,29269,2968009,2997278
9929,"Bullies",1986,2995527,0,2995527
9930,"North Sea Hijack",1980,2993772,0,2993772
9931,"Shoot on Sight",2008,1350230,1642650,2992880
9932,"Tanguy, le retour",2019,0,2992504,2992504
9933,"Mark Twain's America 3D",1998,2992106,0,2992106
9934,"Rusalka: Ozero myortvykh",2018,0,2990620,2990620
9935,"Smetto quando voglio - Ad Honorem",2017,0,2990409,2990409
9936,"On ne choisit pas sa famille",2011,0,2987953,2987953
9937,"Nihon de ichiban warui yatsura",2016,0,2985774,2985774
9938,"Loro 2",2018,0,2984733,2984733
9939,"The Squad",2015,0,2975825,2975825
9940,"Married Life",2008,1506998,1468190,2975188
9941,"En las buenas y en las malas",2019,0,2974327,2974327
9942,"Homicide",1991,2971661,0,2971661
9943,"Lieol",2017,0,2970964,2970964
9944,"Un Petit Boulet",2016,0,2964260,2964260
9945,"Basquiat",1996,2962051,0,2962051
9946,"Débarquement immédiat!",2016,0,2959253,2959253
9947,"Como Novio de Pueblo",2019,0,2958673,2958673
9948,"Begum Jaan",2017,0,2956478,2956478
9949,"The Pirate",1948,2956000,0,2956000
9950,"976-Evil",1989,2955917,0,2955917
9951,"20:16",2017,0,2955320,2955320
9952,"Isn't She Great",2000,2954405,0,2954405
9953,"Wonlain",2017,0,2954086,2954086
9954,"Kamen Raidâ × Kamen Raidâ Gôsuto ando Doraibu C…",2015,0,2952681,2952681
9955,"My Tutor Friend 2",2007,0,2952412,2952412
9956,"Direktøren for det hele",2007,51300,2900000,2951300
9957,"Wonderstruck",2017,1033632,1915230,2948862
9958,"Amoureux de ma femme",2018,0,2947394,2947394
9959,"The Met: Live in HD - Aida",2013,2800000,143797,2943797
9960,"Genis Aile: Yapistir",2015,0,2942694,2942694
9961,"Hidalgo: La historia jamás contada",2010,0,2941672,2941672
9962,"The Double",2011,99612,2841276,2940888
9963,"Filly Brown",2013,2850357,90054,2940411
9964,"Shippû rondo",2016,0,2940357,2940357
9965,"Southern Comfort",1981,2939174,0,2939174
9966,"Strayed",2004,482357,2456075,2938432
9967,"Metropolitan",1990,2938000,0,2938000
9968,"Meu Nome Nao E Johnny",2008,0,2937005,2937005
9969,"Love! Valour! Compassion!",1997,2936611,0,2936611
9970,"Joan Rivers: A Piece of Work",2010,2930687,0,2930687
9971,"Der kleine Rabe Socke - Das große Rennen",2015,0,2929442,2929442
9972,"La douleur",2018,103770,2823502,2927272
9973,"Kein Bund fürs Leben",2007,0,2927117,2927117
9974,"Love is Strange",2014,2262555,662662,2925217
9975,"Blood Ties",2013,42472,2881487,2923959
9976,"Waiting for Guffman",1997,2922988,0,2922988
9977,"This is My Life",1992,2922094,0,2922094
9978,"Titus",1999,1921350,999266,2920616
9979,"Floride",2015,0,2920081,2920081
9980,"Pao Cai",2014,0,2920000,2920000
9981,"Re Loca",2018,0,2918699,2918699
9982,"Doctor Who: The Day of the Doctor",2013,0,2918455,2918455
9983,"Opiseu",2015,0,2914592,2914592
9984,"Homework",1982,2914328,0,2914328
9985,"Crimes of Passion",1984,2912945,0,2912945
9986,"Hwaiteu: Jeojooui Mellodi",2011,0,2912396,2912396
9987,"Dschungelkind",2010,0,2911348,2911348
9988,"Ja, Ik Wil!",2015,0,2908354,2908354
9989,"Lino - Uma Aventura de Sete Vidas",2017,0,2907943,2907943
9990,"Zhenshchiny protiv muzhchin",2015,0,2907636,2907636
9991,"Cuando los Hijos Regresan",2017,0,2906566,2906566
9992,"Geurimja Salin",2009,0,2904792,2904792
9993,"Sylvia",2003,1302242,1601895,2904137
9994,"Karthik Calling Karthik",2010,286409,2615437,2901846
9995,"Raising Victor Vargas",2003,2073984,826594,2900578
9996,"Midnight Madness",1980,2900000,0,2900000
9997,"On the Town",1949,2900000,0,2900000
9998,"Cradle Will Rock",1999,2899970,0,2899970
9999,"Find Me Guilty",2006,1173673,1724552,2898225
10000,"Cashback",2007,25343,2871645,2896988
